AACG=ATA Creativity Global
AACI=Armada Acquisition Corp. I
AACIU=Armada Acquisition Corp. I Unit
AACIW=Armada Acquisition Corp. I
AADI=Aadi Bioscience, Inc.
AAGR=African Agriculture Holdings Inc.
AAGRW=African Agriculture Holdings Inc.
AAL=American Airlines Group Inc
AAME=Atlantic American Corp
AAOI=Applied Optoelectronics Inc
AAON=AAON Inc
AAPL=Apple Inc
AATC=Autoscope Technologies Corporation
ABAT=American Battery Technology Co.
ABCB=Ameris Bancorp
ABCL=AbCellera Biologics Inc
ABEO=Abeona Therapeutics Inc
ABIO=ARCA biopharma Inc
ABL=Abacus Life Inc
ABLLL=Abacus Life, Inc.
ABLV=Able View Global Inc. - Class B Ordinary Shares
ABNB=Airbnb, Inc.
ABOS=Acumen Pharmaceuticals, Inc.
ABSI=Absci Corporation
ABTS=Abits Group Inc
ABUS=Arbutus Biopharma Corp
ABVC=American BriVision (Holding) Corporation
ABVX=Abivax SA
ACAB=Atlantic Coastal Acquisition Corp. II
ACABU=Atlantic Coastal Acquisition Corp II
ACABW=Atlantic Coastal Acquisition Corp. II
ACAC=Acies Acquisition Corp.
ACACU=Acri Capital Acquisition Corp
ACACW=Acri Capital Acquisition Corporation
ACAD=ACADIA Pharmaceuticals Inc
ACAH=Atlantic Coastal Acquisition Corp.
ACAHU=Atlantic Coastal Acquisition Corp.
ACAXW=Alset Capital Acquisition Corp.
ACB=Aurora Cannabis Inc
ACBA=Ace Global Business Acquisition Limited
ACBAU=Ace Global Business Acquisition Limited
ACBAW=Ace Global Business Acquisition Limited
ACCD=Accolade Inc
ACDC=ProFrac Holding Corp
ACET=Adicet Bio, Inc.
ACGL=Arch Capital Group Ltd
ACGLN=Arch Capital Group Ltd.
ACGLO=Arch Capital Group Ltd
ACHC=Acadia Healthcare Co Inc
ACHL=Achilles Therapeutics plc
ACHV=Achieve Life Sciences Inc
ACIC=American Coastal Insurance Corporation
ACIU=AC Immune SA
ACIW=ACI Worldwide Inc
ACLS=Axcelis Technologies Inc
ACLX=Arcellx, Inc.
ACMR=ACM Research Inc
ACNB=ACNB Corp
ACNT=Ascent Industries Co.
ACON=Aclarion, Inc.
ACONW=Aclarion, Inc.
ACOR=Acorda Therapeutics Inc
ACQRW=Independence Holdings Corp.
ACRS=Aclaris Therapeutics Inc
ACRV=Acrivon Therapeutics, Inc.
ACRX=AcelRx Pharmaceuticals Inc
ACST=Acasti Pharma Inc
ACTG=Acacia Research Corp
ACVA=ACV Auctions Inc.
ACXP=Acurx Pharmaceuticals, Inc.
ADAG=Adagene Inc.
ADAP=Adaptimmune Therapeutics Plc
ADBE=Adobe Inc
ADD=Color Star Technology Co. Ltd.
ADEA=Adeia Inc.
ADEAV=Xperi Holding Corporation
ADES=ADES International Holding PLC
ADGI=Adagio Therapeutics, Inc.
ADI=Analog Devices Inc
ADIL=Adial Pharmaceuticals Inc
ADMA=ADMA Biologics Inc
ADN=Advent Technologies Holdings, Inc.
ADNWW=Advent Technologies Holdings, Inc.
ADOC=Edoc Acquisition Corp.
ADOCR=Edoc Acquisition Corp.
ADOCW=Edoc Acquisition Corp.
ADP=Automatic Data Processing Inc
ADPT=Adaptive Biotechnologies Corp
ADSE=ADS-TEC Energy PLC
ADSEW=ADS-TEC Energy PLC
ADSK=Autodesk Inc
ADTH=AdTheorent Holding Company, Inc.
ADTHW=AdTheorent Holding Company, Inc.
ADTN=ADTRAN Inc
ADTX=Aditx Therapeutics Inc
ADUS=Addus HomeCare Corp
ADV=Advantage Solutions Inc
ADVM=Adverum Biotechnologies Inc
ADVWW=Advantage Solutions Inc.
ADXN=Addex Therapeutics Ltd
ADXS=Advaxis Inc
AEAE=AltEnergy Acquisition Corp.
AEAEU=AltEnergy Acquisition Corp.
AEAEW=AltEnergy Acquisition Corp.
AEHL=Antelope Enterprise Holdings Limited
AEHR=Aehr Test Systems
AEI=Alset EHome International Inc.
AEIS=Advanced Energy Industries Inc
AEMD=Aethlon Medical Inc
AENT=Alliance Entertainment Holding Corporation
AENTW=Alliance Entertainment Holding Corporation
AEP=American Electric Power Co Inc
AERT=Aeries Technology, Inc.
AERTW=Aeries Technology, Inc
AEYE=AudioEye Inc
AEZS=Aeterna Zentaris Inc
AFAR=Aura FAT Projects Acquisition Corp
AFARU=Aura FAT Projects Acquisition Corp
AFARW=Aura FAT Projects Acquisition Corp
AFBI=Affinity Bancshares, Inc.
AFCG=AFC Gamma, Inc.
AFIB=Acutus Medical, Inc.
AFJK=Aimei Health Technology Co., Ltd Ordinary Share
AFJKR=Aimei Health Technology Co., Ltd Right
AFJKU=Aimei Health Technology Co., Ltd
AFMD=Affimed NV
AFRI=Forafric Global PLC
AFRIW=Forafric Global PLC
AFRM=Affirm Holdings, Inc.
AFYA=Afya Ltd
AGAE=Allied Gaming & Entertainment Inc.
AGBA=Agba Acquisition Ltd
AGBAW=AGBA Group Holding Limited
AGEN=Agenus Inc
AGFY=Agrify Corporation
AGGRW=Agile Growth Corp.
AGIO=Agios Pharmaceuticals Inc
AGMH=AGM Group Holdings Inc
AGNC=AGNC Investment Corp
AGNCL=AGNC Investment Corp. - Depositary Shares Each Representing a 1/1,000th Interest in a Share of 7.75% Series G Fixed-Rate Reset Cumulative Redeemable Preferred S
AGNCM=AGNC Investment Corp
AGNCN=AGNC Investment Corp
AGNCO=AGNC Investment Corp
AGNCP=AGNC Investment Corp
AGRI=AgriFORCE Growing Systems, Ltd.
AGRIW=AgriFORCE Growing Systems Ltd.
AGYS=Agilysys Inc
AHCO=AdaptHealth Corp
AHG=599855
AHI=Avadim Health Inc
AHPA=Avista Public Acquisition Corp. II
AIB=AIB Acquisition Corporation
AIBBR=AIB Acquisition Corporation
AIBBU=AIB Acquisition Corp
AIH=Aesthetic Medical International Holdings Group Ltd
AIHS=Senmiao Technology Ltd
AILE=iLearningEngines Holdings, Inc.
AILEW=Arrowroot Acquisition Corp.
AIMAU=Aimfinity Investment Corp. I
AIMAW=Aimfinity Investment Corp. I
AIMBU=Aimfinity Investment Corp. I - Subunit
AIMD=Ainos, Inc.
AIMDW=Ainos, Inc.
AIP=Arteris, Inc.
AIRE=reAlpha Tech Corp.
AIRG=Airgain Inc
AIRJ=Power & Digital Infrastructure Acquisition II Corp.
AIRJW=Montana Technologies LLC
AIRS=AirSculpt Technologies, Inc.
AIRT=Air T Inc
AIRTP=Air T Funding
AISP=Airship AI Holdings, Inc
AISPW=Airship AI Holdings, Inc.
AITR=AI TRANSPORTATION ACQUISITION CORP
AITRR=AI Transportation Acquisition Corp
AITRU=AI TRANSPORTATION ACQUISITION CORP
AKAM=Akamai Technologies Inc
AKAN=Akanda Corp.
AKBA=Akebia Therapeutics Inc
AKLI=Akili Inc
AKRO=Akero Therapeutics Inc
AKTS=Akoustis Technologies Inc
AKTX=Akari Therapeutics PLC
AKYA=Akoya Biosciences, Inc.
ALAB=Astera Labs, Inc.
ALAR=Alarum Technologies Ltd.
ALBT=Avalon GloboCare Corp.
ALCE=Alternus Clean Energy, Inc.
ALCO=Alico Inc
ALCY=Alchemy Investments Acquisition Corp 1 - Class A Ordinary Shares
ALDX=Aldeyra Therapeutics Inc
ALEC=Alector Inc
ALGM=Allegro MicroSystems Inc
ALGN=Align Technology Inc
ALGS=Aligos Therapeutics Inc
ALGT=Allegiant Travel Co
ALHC=Alignment Healthcare, Inc.
ALIM=Alimera Sciences Inc
ALKS=Alkermes PLC
ALKT=Alkami Technology, Inc.
ALLK=Allakos Inc
ALLO=Allogene Therapeutics Inc
ALLR=Allarity Therapeutics, Inc.
ALLT=Allot Ltd
ALNT=Allient Inc
ALNY=Alnylam Pharmaceuticals Inc
ALOT=AstroNova Inc
ALPN=Alpine Immune Sciences Inc
ALPP=Alpine 4 Technologies Ltd.
ALRM=Alarm.com Holdings Inc
ALRN=Aileron Therapeutics Inc
ALRS=Alerus Financial Corp
ALSA=Alpha Star Acquisition Corporation
ALSAR=Alpha Star Acquisition Corporation
ALSAU=Alpha Star Acquisition Corporation
ALSAW=Alpha Star Acquisition Corporation
ALT=Altimmune Inc
ALTI=Cartesian Growth Corporation
ALTO=Alto Ingredients, Inc.
ALTR=Altair Engineering Inc
ALTU=Altitude Acquisition Corp.
ALTUU=Altitude Acquisition Corp.
ALTUW=Altitude Acquisition Corp.
ALVO=Alvotech
ALVOW=Alvotech
ALVR=AlloVir, Inc.
ALXO=ALX Oncology Holdings Inc.
ALZN=Alzamend Neuro, Inc.
AMAL=Amalgamated Bank
AMAT=Applied Materials Inc
AMBA=Ambarella Inc
AMCI=AMCI Acquisition Corp
AMCX=AMC Networks Inc
AMD=Advanced Micro Devices Inc
AMED=Amedisys Inc
AMEH=Apollo Medical Holdings Inc
AMGN=Amgen Inc
AMIX=Autonomix Medical, Inc. Common Stock
AMKR=Amkor Technology Inc
AMLI=AMERICAN LITHIUM CORP
AMLX=Amylyx Pharmaceuticals, Inc.
AMNB=American National Bankshares Inc
AMOT=Allied Motion Technologies, Inc.
AMPG=Amplitech Group Inc.
AMPGW=AmpliTech Group, Inc.
AMPH=Amphastar Pharmaceuticals Inc
AMPL=Amplitude, Inc.
AMRK=A-Mark Precious Metals Inc
AMRN=Amarin Corp PLC
AMRX=Amneal Pharmaceuticals Inc
AMSC=American Superconductor Corp
AMSF=AMERISAFE Inc
AMST=Amesite Operating Co
AMSWA=American Software Inc-GA
AMTX=Aemetis Inc
AMWD=American Woodmark Corp
AMYT=Amryt Pharma plc
AMZN=Amazon.com Inc
ANAB=AnaptysBio Inc
ANDE=Andersons Inc-The
ANEB=Anebulo Pharmaceuticals, Inc.
ANGH=Anghami Inc.
ANGHW=Anghami Inc.
ANGI=ANGI Homeservices Inc
ANGO=AngioDynamics Inc
ANIK=Anika Therapeutics Inc
ANIP=ANI Pharmaceuticals Inc
ANIX=Anixa Biosciences Inc
ANL=Adlai Nortye Ltd. - American Depositary Shares
ANNX=Annexon, Inc.
ANSC=Agriculture & Natural Solutions Acquisition Corporation
ANSCU=Agriculture & Natural Solutions Acquisition Corporation
ANSCW=Agriculture & Natural Solutions Acquisition Corporation
ANSS=ANSYS Inc
ANTE=AirNet Technology Inc
ANTX=AN2 Therapeutics, Inc.
ANY=Sphere 3D Corp
AOGO=Arogo Capital Acquisition Corp
AOGOU=Arogo Capital Acquisition Corp
AOGOW=Arogo Capital Acquisition Corp.
AONC=American Oncology Network Inc
AOSL=Alpha & Omega Semiconductor Ltd
AOUT=American Outdoor Brands Inc
APA=Apache Corp
APAC=StoneBridge Acquisition Corporation
APACU=StoneBridge Acquisition Corporation
APACW=StoneBridge Acquisition Corporation
APCX=AppTech Corp.
APCXW=AppTech Payments Corp.
APDN=Applied DNA Sciences Inc
APEI=American Public Education Inc
APGE=Apogee Therapeutics, Inc. - Common Stock
API=Agora Inc
APLD=Applied Science Products, Inc.
APLM=Apollomics Inc
APLS=Apellis Pharmaceuticals Inc
APLT=Applied Therapeutics Inc
APM=Aptorum Group Ltd
APOG=Apogee Enterprises Inc
APP=AppLovin Corporation
APPF=Appfolio Inc
APPN=Appian Corp
APPS=Digital Turbine Inc
APRE=Aprea Therapeutics Inc
APTM=Alpha Partners Technology Merger Corp.
APTO=Aptose Biosciences Inc
APVO=Aptevo Therapeutics Inc
APWC=Asia Pacific Wire & Cable Corp Ltd
APXI=APx Acquisition Corp. I
APXIU=APx Acquisition Corp. I Unit
APXIW=APx Acquisition Corp. I
APYX=Apyx Medical Corp
AQB=AquaBounty Technologies Inc
AQMS=Aqua Metals Inc
AQST=Aquestive Therapeutics Inc
AQU=Aquaron Acquisition Corp.
AQUNR=Aquaron Acquisition Corp.
AQUNU=Aquaron Acquisition Corp
ARAY=Accuray Inc
ARBB=ARB IOT Group Limited - Ordinary Shares
ARBE=Arbe Robotics Ltd.
ARBEW=Arbe Robotics Ltd.
ARBK=Argo Blockchain plc American Depositary Shares
ARBKL=Argo Blockchain plc 8.75% Senior Notes due 2026
ARCB=ArcBest Corp
ARCT=Arcturus Therapeutics Holdings Inc
ARDS=Aridis Pharmaceuticals Inc
ARDX=Ardelyx Inc
AREB=American Rebel Holdings, Inc.
AREBW=American Rebel Holdings, Inc.
AREC=American Resources Corp
ARGX=Argenx SE
ARHS=Arhaus, Inc.
ARIZ=Arisz Acquisition Corp.
ARIZR=Arisz Acquisition Corp.
ARIZU=Arisz Acquisition Corp.
ARIZW=Arisz Acquisition Corp.
ARKO=Arko Corp.
ARKOW=Arko Corp.
ARKR=Ark Restaurants Corp
ARLP=Alliance Resource Partners LP
ARM=Arm Holdings plc - American Depositary Shares
AROW=Arrow Financial Corp
ARPO=Aerpio Pharmaceuticals Inc
ARQ=Arq, Inc.
ARQQ=Arqit Quantum Inc.
ARQQW=Arqit Quantum Inc.
ARQT=Arcutis Biotherapeutics Inc
ARRW=Arrowroot Acquisition Corp.
ARRWU=Arrowroot Acquisition Corp.
ARRWW=Arrowroot Acquisition Corp.
ARRY=Array BioPharma Inc
ARTA=Artisan Acquisition Corp.
ARTL=Artelo Biosciences Inc
ARTLW=Artelo Biosciences, Inc.
ARTNA=Artesian Resources Corp
ARTW=Art's-Way Manufacturing Co Inc
ARVN=Arvinas Inc
ARWR=Arrowhead Pharmaceuticals Inc
ARYD=ARYA Sciences Acquisition Corp IV
ASCA=A SPAC I Acquisition Corp.
ASCAR=A SPAC I Acquisition Corp.
ASCAU=A SPAC I Acquisition Corp
ASCAW=A SPAC I Acquisition Corp.
ASCB=A SPAC II Acquisition Corporation
ASCBR=A SPAC II Acquisition Corporation
ASCBU=A SPAC II Acquisition Corporation
ASCBW=A SPAC II Acquisition Corporation
ASLE=AerSale Corporation
ASLN=Aslan Pharmaceuticals Ltd
ASMB=Assembly Biosciences Inc
ASML=ASML Holding NV
ASND=Ascendis Pharma A/S 
ASNS=Actelis Networks, Inc.
ASO=Academy Sports & Outdoors Inc
ASPAW=Abri SPAC I, Inc.
ASPI=Aspire Real Estate Investors Inc
ASPS=Altisource Portfolio Solutions SA
ASPU=Aspen Group Inc-CO
ASRT=Assertio Therapeutics Inc
ASRV=AmeriServ Financial Inc
ASST=Asset Entities Inc.
ASTC=Astrotech Corp
ASTE=Astec Industries Inc
ASTH=Astrana Health Inc.
ASTI=Ascent Solar Technologies, Inc.
ASTL=Algoma Steel Group Inc.
ASTLW=Algoma Steel Group Inc.
ASTR=Astra Space, Inc.
ASTS=AST SpaceMobile, Inc.
ASTSW=AST SpaceMobile, Inc.
ASUR=Asure Software Inc
ASYS=Amtech Systems Inc
ATAI=ATA Inc-China
ATAT=Atour Lifestyle Holdings Limited
ATAX=America First Multifamily Investors LP
ATCOL=Atlas Corp.
ATEC=Alphatec Holdings Inc
ATER=Aterian, Inc.
ATEX=pdvWireless Inc
ATGL=Alpha Technology Group Limited
ATHA=Athira Pharma Inc
ATHE=Alterity Therapeutics ltd
ATIF=ATIF Holdings Ltd
ATLC=Atlanticus Holdings Corp
ATLCL=Atlanticus Holdings Corporation 6.125% Senior Notes due 2026
ATLCP=Atlanticus Holdings Corporation
ATLCZ=Atlanticus Holdings Corporation 9.25% Senior Notes due 2029
ATLO=Ames National Corp
ATLX=Atlas Lithium Corporation
ATMC=ALPHATIME ACQUISITION CORP
ATMCR=AlphaTime Acquisition Corp Right
ATMCU=AlphaTime Acquisition Corp
ATMCW=AlphaTime Acquisition Corp Warrant
ATMV=AlphaVest Acquisition Corp
ATMVR=AlphaVest Acquisition Corp Right
ATMVU=AlphaVest Acquisition Corp
ATNF=180 Life Sciences Corp.
ATNFW=CannBioRx Life Sciences Corp.
ATNI=ATN International Inc
ATOM=Atomera Inc
ATOS=Atossa Genetics Inc
ATPC=Agape Atp Corp
ATRA=Atara Biotherapeutics Inc
ATRC=AtriCure Inc
ATRI=Atrion Corp
ATRO=Astronics Corp
ATSG=Air Transport Services Group Inc
ATXG=Addentax Group Corp
ATXI=Avenue Therapeutics Inc
ATXS=Astria Therapeutics, Inc.
AUBAP=Atlantic Union Bankshares Corporation
AUBN=Auburn National Bancorporation Inc
AUDC=AudioCodes Ltd
AUGX=Augmedix, Inc.
AUID=Ipsidy Inc.
AUPH=Aurinia Pharmaceuticals Inc
AUR=Aurora Innovation, Inc.
AURA=Aura Biosciences, Inc.
AURC=Aurora Acquisition Corp.
AUROW=Aurora Innovation, Inc.
AUTL=Autolus Therapeutics PLC
AUUD=Auddia Inc.
AUUDW=Auddia Inc.
AUVI=Applied UV, Inc.
AUVIP=Applied UV, Inc.
AVAH=Aveanna Healthcare Holdings Inc.
AVAV=Aerovironment Inc
AVBP=ARRIVENT BIOPHARMA INC
AVCO=Avalon GloboCare Corp
AVDL=Avadel Pharmaceuticals PLC
AVDR=Avedro Inc
AVDX=AvidXchange Holdings, Inc.
AVGO=Broadcom Inc
AVGR=Avangardco Investments Public Ltd
AVIR=Atea Pharmaceuticals Inc
AVNW=Aviat Networks Inc
AVO=Mission Produce Inc
AVPT=AvePoint, Inc.
AVPTW=AvePoint Inc
AVRO=Avrobio Inc
AVT=Avnet Inc
AVTE=Aerovate Therapeutics, Inc.
AVTX=Avalo Therapeutics, Inc.
AVXL=Anavex Life Sciences Corp
AWH=Aspira Women's Health Inc.
AWIN=AERWINS Technologies Inc. - Common Stock
AWRE=Aware Inc-MA
AXDX=Accelerate Diagnostics Inc
AXGN=AxoGen Inc
AXNX=Axonics Modulation Technologies Inc
AXON=Axon Enterprise, Inc.
AXSM=Axsome Therapeutics Inc
AXTI=AXT Inc
AY=Atlantica Yield plc
AYRO=Ayro, Inc.
AYTU=Aytu BioScience Inc
AZ=A2Z Smart Technologies Corp.
AZN=AstraZeneca PLC
AZPN=Aspen Technology Inc
AZRX=AzurRx BioPharma Inc
AZTA=Azenta, Inc.
AZYO=Aziyo Biologics, Inc.
BACK=IMAC Holdings, Inc.
BAER=Bridger Aerospace Group Holdings, Inc.
BAERW=Bridger Aerospace Group Holdings, Inc. Warrant
BAFN=BayFirst Financial Corp.
BAND=Bandwidth Inc
BANF=BancFirst Corp
BANFP=BFC Capital Trust II
BANL=CBL International Limited - Ordinary Shares
BANR=Banner Corp
BANX=StoneCastle Financial Corp
BAOS=Baosheng Media Group Holdings Limited Ordinary shares
BASE=Couchbase, Inc.
BATRA=Liberty Media Corp-Liberty Braves
BATRK=Liberty Media Corp-Liberty Braves
BAYAR=Bayview Acquisition Corp
BAYAU=Bayview Acquisition Corp
BBCP=Concrete Pumping Holdings Inc
BBGI=Beasley Broadcast Group Inc
BBIG=Vinco Ventures, Inc.
BBIO=Bridgebio Pharma Inc
BBLG=Bone Biologics Corp
BBLGW=Bone Biologics Corporation
BBSI=Barrett Business Services Inc
BCAB=BioAtla, Inc.
BCAL=Bank of Southern California, National Association
BCAN=BYND Cannasoft Enterprises Inc.
BCBP=BCB Bancorp Inc
BCDA=BioCardia Inc
BCDAW=BioCardia, Inc.
BCG=Binah Capital Group, Inc.
BCGWW=Binah Capital Group, Inc.
BCLI=BrainStorm Cell Therapeutics Inc
BCML=Baycom Corp
BCOV=Brightcove Inc
BCOW=1895 Bancorp of Wisconsin Inc
BCPC=Balchem Corp
BCRX=BioCryst Pharmaceuticals Inc
BCSA=Blockchain Coinvestors Acquisition Corp. I
BCSAU=Blockchain Coinvestors Acquisition Corp. I
BCSAW=Blockchain Coinvestors Acquisition Corp. I
BCTX=BriaCell Therapeutics Corp.
BCTXW=BriaCell Therapeutics Corp.
BCYC=Bicycle Therapeutics Ltd
BDSI=BioDelivery Sciences International Inc
BDSX=Biodesix Inc
BDTX=Black Diamond Therapeutics Inc
BEAM=Beam Therapeutics Inc
BEAT=BioTelemetry Inc
BEATW=HeartBeam, Inc.
BECN=Beacon Roofing Supply Inc
BEEM=Beam Global
BEEMW=Beam Global
BELFA=Bel Fuse Inc
BELFB=Bel Fuse Inc
BENF=Beneficient
BETR=Better Home & Finance Holding Co.
BETS=Seaniemac International, Ltd.
BFC=Bank First Corp
BFI=BurgerFi International, Inc.
BFIIW=BurgerFi International, LLC
BFIN=BankFinancial Corp
BFRG=Bullfrog AI Holdings, Inc. Common Stock
BFRGW=Bullfrog AI Holdings, Inc. Warrants
BFRI=Biofrontera Inc.
BFRIW=Biofrontera Inc.
BFST=Business First Bancshares Inc
BGC=Bgc Partners Inc
BGFV=Big 5 Sporting Goods Corp
BGLC=Bionexus Gene Lab Corp.
BGNE=BeiGene Ltd
BGXX=Bright Green Corporation
BHAC=Crixus BH3 Acquisition Company
BHACU=Crixus BH3 Acquisition Company
BHACW=Crixus BH3 Acquisition Company
BHAT=Blue Hat Interactive Entertainment Technology
BHF=Brighthouse Financial Inc
BHFAL=Brighthouse Financial Inc
BHFAM=Brighthouse Financial, Inc. - D
BHFAN=Brighthouse Financial, Inc.
BHFAO=Brighthouse Financial, Inc.
BHFAP=Brighthouse Financial Inc
BHRB=Burke & Herbert Bank & Trust Co. (Alexandria, VA)
BHSE=Bull Horn Holdings Corp.
BIAF=bioAffinity Technologies, Inc. 
BIAFW=bioAffinity Technologies, Inc.
BIDU=Baidu Inc
BIGC=BigCommerce Holdings Inc
BIIB=Biogen Inc
BILI=Bilibili Inc
BIMI=NF Energy Saving Corp
BIOL=Biolase Inc
BIOR=Biora Therapeutics, Inc.
BIOX=Bioceres Crop Solutions Corp
BIRD=Allbirds, Inc.
BITF=Bitfarms Ltd.
BIVI=BioVie Inc.
BJDX=Bluejay Diagnostics, Inc.
BJRI=BJ's Restaurants Inc
BKHAU=Black Hawk Acquisition Corporation
BKNG=Booking Holdings Inc
BKR=Baker Hughes Co
BKYI=Bio-key International Inc
BL=Blackline Inc
BLAC=Bellevue Life Sciences Acquisition Corp. - Common Stock
BLACU=Bellevue Life Sciences Acquisition Corp. Unit
BLBD=BLOM Bank SAL
BLBX=Blackboxstocks Inc.
BLDE=Blade Air Mobility, Inc.
BLDEW=Blade Air Mobility, Inc.
BLDP=Ballard Power Systems Inc
BLEU=bleuacacia ltd
BLEUR=bleuacacia ltd
BLEUU=bleuacacia ltd
BLEUW=bleuacacia ltd
BLFS=BioLife Solutions Inc
BLFY=Blue Foundry Bancorp
BLIN=Bridgeline Digital Inc
BLKB=Blackbaud Inc
BLMN=Bloomin' Brands Inc
BLNK=Blink Charging Co
BLRX=BioLine RX Ltd
BLTE=Belite Bio, Inc
BLUE=Bluebird Bio Inc
BLZE=Backblaze, Inc.
BMBL=Bumble Inc.
BMEA=Biomea Fusion, Inc.
BMLP=Dorsey Wright MLP Index ETNs
BMR=Beamr Imaging Ltd.
BMRA=Biomerica Inc
BMRC=Bank of Marin Bancorp
BMRN=BioMarin Pharmaceutical Inc
BNAI=DHC Acquisition Corp.
BNAIW=Brand Engagement Network, Inc.
BNGO=BioNano Genomics Inc
BNIX=Bannix Acquisition Corp.
BNIXR=Bannix Acquisition Corp.
BNIXW=Bannix Acquisition Corp.
BNOX=Bionomics Limited American Depository Shares
BNR=Burning Rock Biotech Ltd
BNRG=Brenmiller Energy Ltd
BNTC=Benitec Biopharma Ltd
BNTX=BioNTech SE
BNZI=Banzai International, Inc.
BNZIW=Banzai International, Inc.
BOCN=Blue Ocean Acquisition Corp
BOCNU=Blue Ocean Acquisition Corp Unit
BOCNW=Blue Ocean Acquisition Corp
BOF=BranchOut Food Inc. - Common Stock
BOKF=BOK Financial Corp
BOLD=Audentes Therapeutics Inc
BOLT=Bolt Biotherapeutics, Inc.
BON=Bon Natural Life Limited
BOOM=DMC Global Inc
BOSC=BOS Better On-Line Solutions
BOTJ=Bank of the James Financial Group Inc
BOTT=Themes Robotics & Automation ETF
BOWN=Bowen Acquisition Corp - Ordinary Shares
BOXL=Boxlight Corp
BPMC=Blueprint Medicines Corp
BPOP=Popular Inc
BPOPM=Popular Capital Trust II
BPRN=Bank of Princeton-The
BPTH=Bio-Path Holdings Inc
BPTS=Biophytis SA
BPYPM=Brookfield Property Preferred L.P.
BPYPN=Brookfield Property Partners LP
BPYPO=Brookfield Property Partners LP
BPYPP=Brookfield Property Partners LP
BRAC=Black Ridge Acquisition Corp
BRACR=Broad Capital Acquisition Corp
BRACU=Black Ridge Acquisition Corp
BRAG=Bragg Gaming Group Inc.
BREA=BRERA HOLDINGS PLC
BREZ=Breeze Holdings Acquisition Corp.
BREZR=Breeze Holdings Acquisition Corp.
BREZW=Breeze Holdings Acquisition Corp.
BRFH=Barfresh Food Group Inc.
BRID=Bridgford Foods Corp
BRKH=BurTech Acquisition Corp. Class A common stock
BRKHU=BURTECH ACQUISITION CORP UNIT 1
BRKHW=Burtech Acquisition Corp.
BRKL=Brookline Bancorp Inc
BRKR=Bruker Corp
BRKS=Brooks Automation Inc
BRLS=Borealis Foods Inc
BRLSW=Borealis Foods Inc
BRLT=Brilliant Earth Group, Inc.
BRNS=Barinthus Biotherapeutics plc
BROG=Twelve Seas Investment Co
BROGW=Brooge Energy Limited
BRP=BRP Group Inc
BRPM=B Riley Principal Merger Corp
BRRR=Valkyrie Bitcoin Fund
BRSH=Bruush Oral Care Inc.
BRSHW=Bruush Oral Care Inc.
BRTX=BioRestorative Therapies, Inc.
BRY=Berry Petroleum Co LLC
BRZE=Braze, Inc. Class A Common Stock
BSBK=Bogota Financial Corp
BSET=Bassett Furniture Industries Inc
BSFC=BLUE STAR FOODS CORP.
BSGA=Blue Safari Group Acquisition Corp.
BSGM=BioSig Technologies Inc
BSKYW=Big Sky Growth Partners, Inc.
BSRR=Sierra Bancorp
BSVN=Bank7 Corp
BSY=Bentley Systems Inc
BTAI=Bioxcel Therapeutics Inc
BTBD=BT Brands, Inc.
BTBDW=BT Brands, Inc.
BTBT=Bit Digital, Inc.
BTCS=BTCS Inc.
BTCT=Btc Digital Ltd.
BTCY=Biotricity Inc.
BTDR=Bitdeer Technologies Group - Ordinary Shares
BTFX=VALKYRIE BITCOIN FUTURES LEVERAGED STRATEGY ETF
BTM=Bitcoin Depot Inc. - Class A Common Stock
BTMD=Biote Corp
BTOG=Bit Origin Ltd
BTSG=BRIGHTSPRING HEALTH SERVICES INC
BTSGU=BRIGHTSPRING HEALTH SERVICES INC TANGIBLE EQUITY UNIT
BTTX=Better Therapeutics, Inc.
BTWN=Bridgetown Holdings Limited
BUJA=Bukit Jalil Global Acquisition 1 Ltd. - Ordinary Shares
BUSE=First Busey Corp
BVFL=BV Financial, Inc.
BVS=Bioventus Inc.
BVXV=BiondVax Pharmaceuticals Ltd.
BWAQ=Blue World Acquisition Corporation
BWAQR=Blue World Acquisition Corporation
BWAQU=Blue World Acquisition Corp
BWAQW=Blue World Acquisition Corporation
BWAY=Brainsway Ltd
BWB=Bridgewater Bancshares Inc
BWBBP=Bridgewater Bancshares, Inc.
BWEN=Broadwind Energy Inc
BWFG=Bankwell Financial Group Inc
BWMN=Bowman Consulting Group Ltd.
BWMX=Betterware de Mexico SAPI de CV
BXRX=Baudax Bio Inc
BYFC=Broadway Financial Corp-DE
BYND=Beyond Meat Inc
BYNO=byNordic Acquisition Corp
BYNOU=byNordic Acquisition Corp
BYNOW=byNordic Acquisition Corporation
BYRN=BYRNA TECHNOLOGIES INC.
BYSI=Beyondspring Inc
BYU=BAIYU Holdings, Inc.
BZ=Kanzhun Limited
BZFD=BuzzFeed, Inc.
BZFDW=BuzzFeed, Inc.
BZUN=Baozun Inc
CAAS=China Automotive Systems Inc
CABA=Cabaletta Bio Inc
CAC=Camden National Corp
CACC=Credit Acceptance Corp
CACO=Caravelle International Group
CADL=Candel Therapeutics, Inc.
CAKE=Cheesecake Factory Inc-The
CALA=Calithera Biosciences Inc
CALB=California Bancorp
CALC=CALCIMEDICA INC
CALM=Cal-Maine Foods Inc
CALT=Calliditas Therapeutics AB 
CAMP=CalAmp Corp
CAMT=Camtek Ltd-Israel
CAN=Canaan Inc
CANQ=Calamos Alternative Nasdaq & Bond ETF
CAPR=Capricor Therapeutics Inc
CAPT=Captivision Inc.
CAPTW=Captivision Inc.
CAR=Avis Budget Group Inc
CARA=Cara Therapeutics Inc
CARE=Carter Bank & Trust
CARG=Cargurus Inc
CARM=Carisma Therapeutics, Inc. - Common Stock
CART=Carolina Trust Bancshares Inc
CARV=Carver Bancorp Inc
CASA=Casa Systems Inc
CASH=L&G E Fund MSCI China A UCITS ETF
CASI=CASI Pharmaceuticals Inc
CASS=Cass Information Systems Inc
CASY=Casey's General Stores Inc
CATC=Cambridge Bancorp
CATY=Cathay General Bancorp
CAUD=Collective Audience, Inc.
CBAN=Colony Bankcorp Inc
CBAT=CBAK Energy Technology Inc
CBFV=CB Financial Services Inc
CBNK=Capital Bancorp Inc
CBRG=Chain Bridge I
CBRGU=Chain Bridge I
CBRL=Cracker Barrel Old Country Store Inc
CBSH=Commerce Bancshares Inc-MO
CBUS=UBS ETF - Bloomberg Barclays US Liquid Corporates UCITS ETF
CCAIW=Cascadia Acquisition Corp.
CCAP=Crescent Capital BDC Inc
CCB=Coastal Financial Corp-WA
CCBG=Capital City Bank Group Inc
CCCC=C4 Therapeutics Inc
CCCS=CCC Intelligent Solutions Holdings Inc.
CCEP=Coca-Cola European Partners PLC
CCG=Cheche Group Inc. - Class A Ordinary Shares
CCIH=ChinaCache International Holdings Ltd
CCLD=CareCloud, Inc.
CCLDO=CareCloud, Inc. - 8.75% Series B Cumulative Redeemable Perpetual Preferred Stock
CCLDP=CareCloud, Inc. - 11% Series A Cumulative Redeemable Perpetual Preferred Stock
CCLP=CSI Compressco LP
CCNC=Code Chain New Continent Limited
CCNE=CNB Financial Corp-PA
CCNEP=CNB Financial Corporation
CCOI=Cogent Communications Holdings Inc
CCRN=Cross Country Healthcare Inc
CCSI=Consensus Cloud Solutions, Inc.
CCTG=CCSC Technology International Holdings Limited
CCTS=Cactus Acquisition Corp. 1 Limited
CCTSU=Cactus Acquisition Corp. 1 Limited Unit
CCTSW=Cactus Acquisition Corp. 1 Limited
CDAQ=Compass Digital Acquisition Corp.
CDAQU=Compass Digital Acquisition Corp.
CDAQW=Compass Digital Acquisition Corp.
CDEV=Centennial Resource Development Inc-DE
CDIO=Cardio Diagnostics Holdings Inc.
CDIOW=Cardio Diagnostics Holdings, Inc.
CDLX=Cardlytics Inc
CDMO=Avid Bioservices Inc
CDNA=CareDx Inc
CDNS=Cadence Design Systems Inc
CDRO=Codere Online Luxembourg, S.A.
CDROW=Codere Online Luxembourg, S.A.
CDT=Conduit Pharmaceuticals Inc
CDTG=CDT Environmental Technology Investment Holdings Limited ordinary shares
CDTX=Cidara Therapeutics Inc
CDW=CDW Corp-DE
CDXC=ChromaDex Corp
CDXS=Codexis Inc
CDZI=Cadiz Inc
CDZIP=Cadiz Inc.
CEAD=CEA Industries Inc.
CEADW=CEA Industries Inc.
CECE=CECO Environmental Corp
CECO=Career Education Corp
CEG=Constellation Energy Corporation
CELC=Celcuity Inc
CELH=Celsius Holdings Inc
CELU=Celularity Inc.
CELUW=Celularity Inc.
CELZ=Creative Medical Technology Holdings, Inc.
CENN=Cenntro Electric Group Limited
CENT=Central Garden & Pet Co
CENTA=Central Garden & Pet Co
CENX=Century Aluminum Co
CERE=Cerevel Therapeutics Holdings, Inc.
CERO=Phoenix Biotech Acquisition Corp.
CEROW=CERo Therapeutics Holdings, Inc.
CERS=Cerus Corp
CERT=Certara, Inc.
CETU=Cetus Capital Acquisition Corp. - Class A Common Stock
CETUU=Cetus Capital Acquisition Corp. Unit
CETX=Cemtrex Inc
CETXP=Cemtrex Inc
CETY=Clean Energy Technologies, Inc.
CEVA=CEVA Inc
CFB=CrossFirst Bankshares Inc
CFBK=Central Federal Corp
CFFI=C&F Financial Corp
CFFN=Capitol Federal Financial Inc
CFFS=CF Acquisition Corp VII
CFFSU=CF Acquisition Corp. VII Unit
CFFSW=CF Acquisition Corp. VII
CFLT=Confluent, Inc.
CFSB=CFSB Bancorp, Inc.
CG=Carlyle Group LP-The
CGABL=The Carlyle Group Inc. 4.625% Subordinated Notes due 2061
CGBD=TCG BDC Inc
CGBDL=Carlyle Secured Lending, Inc.
CGC=Canopy Growth Corp
CGEM=Cullinan Management, Inc.
CGEN=Compugen Ltd
CGNT=Cognyte Software Ltd.
CGNX=Cognex Corp
CGON=CG Oncology, Inc. Common stock
CGTX=Cognition Therapeutics, Inc.
CHCI=Comstock Holding Cos Inc
CHCO=City Holding Co
CHDN=Churchill Downs Inc
CHEA=Chenghe Acquisition Co.
CHEF=Chefs' Warehouse Inc-The
CHEK=Check Cap Ltd
CHK=Chesapeake Energy Corp
CHKE=2
CHKEL=Chesapeake Energy Corporation
CHKEW=Chesapeake Energy Corporation
CHKEZ=Chesapeake Energy Corporation
CHKP=Check Point Software Technologies Ltd
CHMG=Chemung Financial Corp
CHNR=China Natural Resources Inc
CHPMU=CHP Merger Corp
CHR=Cheer Holding, Inc.
CHRD=Chord Energy Corp
CHRS=Coherus Biosciences Inc
CHRW=CH Robinson Worldwide Inc
CHSCL=CHS Inc
CHSCM=CHS Inc
CHSCN=CHS Inc
CHSCO=CHS Inc
CHSCP=CHS Inc
CHSN=Chanson International Holding - Class A Ordinary Shares
CHTR=Charter Communications Inc
CHUY=Chuy's Holdings Inc
CHX=ChampionX Corporation
CIFR=Cipher Mining Inc.
CIFRW=Cipher Mining Inc.
CIGI=Colliers International Group Inc
CINF=Cincinnati Financial Corp
CING=Cingulate Inc.
CINGW=Cingulate Inc.
CISO=Cerberus Cyber Sentinel Corporation
CISS=C3is Inc. - Common Stock
CITE=Cartica Acquisition Corp
CITEU=Cartica Acquisition Corp
CITEW=Cartica Acquisition Corp
CIVB=Civista Bancshares Inc
CIZN=Citizens Holding Co
CJET=Chijet Motor Company Inc
CJJD=China Jo-Jo Drugstores Inc
CKPT=Checkpoint Therapeutics Inc
CLAQ=CleanTech Acquisition Corp.
CLAR=Clarus Corp
CLBK=Columbia Financial Inc
CLBS=Caladrius Biosciences Inc
CLBT=Cellebrite DI Ltd.
CLBTW=Cellebrite DI Ltd.
CLDX=Celldex Therapeutics Inc
CLEU=China Liberal Education Holdings Ltd
CLFD=Clearfield Inc
CLGN=Collplant Biotechnologies Ltd
CLINW=Clean Earth Acquisitions Corp.
CLIR=ClearSign Combustion Corp
CLLS=Cellectis SA
CLMB=Climb Global Solutions, Inc.
CLMT=Calumet Specialty Products Partners LP
CLNE=Clean Energy Fuels Corp
CLNN=Clene Inc.
CLNNW=Clene Inc.
CLOA=BLACKROCK AAA CLO ETF
CLOE=Clover Leaf Capital Corp.
CLOER=Clover Leaf Capital Corp.
CLOEU=Clover Leaf Capital Corp.
CLOV=Clover Health Investments, Corp.
CLPS=CLPS Inc
CLPT=ClearPoint Neuro Inc
CLRB=Cellectar Biosciences Inc
CLRC=ClimateRock
CLRCR=ClimateRock
CLRCU=ClimateRock
CLRCW=ClimateRock
CLRO=ClearOne Inc
CLSD=Clearside Biomedical Inc
CLSK=Cleanspark Inc
CLSN=Celsion Corp
CLST=Catalyst Bancorp, Inc.
CLVR=Clever Leaves Holdings Inc.
CLVRW=Clever Leaves Holdings Inc.
CLWT=Euro Tech Holdings Co Ltd
CMAX=CareMax, Inc.
CMAXW=CareMax, Inc.
CMBM=Cambium Networks Corp
CMCA=Capitalworks Emerging Markets Acquisition Corp
CMCAU=Capitalworks Emerging Markets Acquisition Corp Unit
CMCAW=Capitalworks Emerging Markets Acquisition Corp
CMCO=Columbus McKinnon Corp-NY
CMCSA=Comcast Corp
CMCT=CIM Commercial Trust Corp
CME=CME Group Inc
CMLS=Cumulus Media Inc
CMMB=Chemomab Therapeutics Ltd.
CMND=Caleminder, Inc.
CMPO=CompoSecure, Inc.
CMPOW=CompoSecure, Inc.
CMPR=Cimpress NV
CMPS=COMPASS Pathways plc
CMPX=Compass Therapeutics Inc
CMRA=Comera Life Sciences Holdings, Inc.
CMRAW=Comera Life Sciences Holdings, Inc.
CMRX=Chimerix Inc
CMTL=Comtech Telecommunications Corp
CNCE=Concert Pharmaceuticals Inc
CNDT=Conduent Inc
CNET=ChinaNet Online Holdings Inc
CNEY=CN Energy Group. Inc.
CNFR=Conifer Holdings Inc
CNGL=Canna-Global Acquisition Corp
CNGLU=Canna-Global Acquisition Corp
CNGLW=Canna-Global Acquisition Corp
CNOB=ConnectOne Bancorp Inc
CNOBP=ConnectOne Bancorp, Inc.
CNSL=Consolidated Communications Holdings Inc
CNSP=CNS Pharmaceuticals Inc
CNTA=Centessa Pharmaceuticals Limited
CNTB=Connect Biopharma Holdings Limited
CNTG=Centogene NV
CNTQ=Chardan NexTech Acquisition 2 Corp.
CNTX=Context Therapeutics Inc.
CNTY=Century Casinos Inc
CNVS=Cinedigm Corp
CNXA=Connexa Sports Technologies Inc.
CNXC=Concentrix Corporation
CNXN=PC Connection Inc
COCH=Envoy Medical, Inc. - Class A Common Stock
COCO=The Vita Coco Company, Inc.
COCP=Cocrystal Pharma Inc
CODA=Coda Octopus Group Inc
CODX=Co-Diagnostics Inc
COEP=Coeptis Therapeutics Holdings, Inc.
COEPW=Coeptis Therapeutics Holdings, Inc.
COFS=ChoiceOne Financial Services Inc
COGT=Cogent Biosciences, Inc.
COHU=Cohu Inc
COIN=Coinbase Global, Inc. Class A Common Stock
COKE=Coca-Cola Consolidated Inc
COLB=Columbia Banking System Inc
COLL=Collegium Pharmaceutical Inc
COLM=Columbia Sportswear Co
COMM=CommScope Holding Co Inc
COMSP=ComSovereign Holding Corp. - 9.
CONN=Conn's Inc
CONX=CONX Corp.
CONXU=CONX Corp.
CONXW=CONX Corp.
COO=Cooper Cos Inc-The
COOL=Corner Growth Acquisition Corp.
COOLU=Corner Growth Acquisition Corp.
COOLW=Corner Growth Acquisition Corp.
COOP=Mr Cooper Group Inc
COOT=Australian Oilseeds Holdings Limited
COOTW=Australian Oilseeds Holdings Limited Warrant
COPP=Sprott Copper Miners ETF
CORT=Corcept Therapeutics Inc
CORZZ=Core Scientific, Inc. Tranche 2 Warrants
COSM=Cosmos Holdings Inc.
COST=Costco Wholesale Corp
COVA=COVA Acquisition Corp.
COWG=Pacer US Large Cap Cash Cows Growth Leaders ETF
COYA=Coya Therapeutics, Inc.
CPBI=Central Plains Bancshares, Inc.
CPHC=Canterbury Park Holding Corp
CPIX=Cumberland Pharmaceuticals Inc
CPLP=Capital Product Partners LP
CPOP=Pop Culture Group Co., Ltd
CPRT=Copart Inc
CPRX=Catalyst Pharmaceuticals Inc
CPSH=CPS Technologies Corp
CPSI=Computer Programs & Systems Inc
CPSS=Consumer Portfolio Services Inc
CPTN=Cepton, Inc.
CPTNW=Cepton, Inc.
CPZ=Calamos Long-Short Equity & Dynamic Income Trust
CRAI=CRA International Inc
CRBP=Corbus Pharmaceuticals Holdings Inc
CRBU=Caribou Biosciences, Inc.
CRCT=Cricut, Inc.
CRDF=Cardiff Oncology, Inc.
CRDL=Cardiol Therapeutics Inc.
CRDO=Credo Technology Group Holding Ltd Ordinary Shares
CREG=China Recycling Energy Corp
CRESW=Cresud Sociedad Anónima Comercial, Inmobiliaria, Financiera y Agropecuaria
CRESY=Cresud SACIF y A
CREV=Carbon Revolution Public Limited Company
CREVW=Carbon Revolution Public Limited Company
CREX=Creative Realities Inc
CRGE=Clenergen Corp.
CRGO=Gesher I Acquisition Corp.
CRGOW=Freightos Limited Warrants
CRGX=CARGO Therapeutics, Inc.
CRIS=Curis Inc
CRKN=Crown ElectroKinetics Corp.
CRMD=CorMedix Inc
CRML=Critical Metals Corp.
CRMLW=Critical Metals Corp.
CRMT=America's Car-Mart Inc-TX
CRNC=Cerence Inc
CRNT=Ceragon Networks Ltd
CRNX=Crinetics Pharmaceuticals Inc
CRON=Cronos Group Inc
CROX=Crocs Inc
CRSP=CRISPR Therapeutics AG
CRSR=Corsair Gaming Inc
CRTD=Creatd Inc.
CRTO=Criteo SA
CRUS=Cirrus Logic Inc
CRVL=CorVel Corp
CRVO=Cervomed Inc
CRVS=Corvus Pharmaceuticals Inc
CRWD=Crowdstrike Holdings Inc
CRWS=Crown Crafts Inc
CRZNW=Corazon Capital V838 Monoceros 
CSBR=Champions Oncology Inc
CSCO=Cisco Systems Inc
CSGP=CoStar Group Inc
CSGS=CSG Systems International Inc
CSIQ=Canadian Solar Inc
CSLM=Consilium Acquisition Corp I, Ltd.
CSLMR=Consilium Acquisition Corp I, Ltd.
CSLMU=Consilium Acquisition Corp I Ltd
CSLMW=Consilium Acquisition Corp I, Ltd.
CSLR=Complete Solaria Inc
CSPI=CSP Inc
CSSE=Chicken Soup For The Soul Entertainment Inc
CSSEL=Chicken Soup for the Soul Entertainment, Inc.
CSSEN=Chicken Soup for the Soul Enter
CSSEP=Chicken Soup For The Soul Entertainment Inc
CSTE=Caesarstone Ltd
CSTL=Castle Biosciences Inc
CSTR=Capstar Financial Holdings Inc
CSWC=Capital Southwest Corp
CSWI=CSW Industrials Inc
CSX=CSX Corp
CTACU=ChaSerg Technology Acquisition Corp
CTAS=Cintas Corp
CTBI=Community Trust Bancorp Inc
CTCX=Carmell Therapeutics Corp
CTHR=Charles & Colvard Ltd
CTIB=Yunhong CTI Ltd.
CTKB=Cytek Biosciences, Inc.
CTLP=Cantaloupe, Inc.
CTMX=CytomX Therapeutics Inc
CTNM=Contineum Therapeutics, Inc. Class A Common Stock
CTNT=Cheetah Net Supply Chain Service Inc. - Class A Common Stock
CTRM=Castor Maritime Inc
CTRN=Citi Trends Inc
CTSH=Cognizant Technology Solutions Corp
CTSO=CytoSorbents Corp
CTXR=Citius Pharmaceuticals Inc
CUE=Cue Biopharma Inc
CUEN=Cuentas Inc.
CUENW=Cuentas Inc.
CULL=Cullman Bancorp Inc.
CURI=CuriosityStream Inc.
CURIW=CuriosityStream Inc.
CUTR=Cutera Inc
CVAC=CureVac NV
CVBF=CVB Financial Corp
CVCO=Cavco Industries Inc
CVCY=Central Valley Community Bancorp
CVGI=Commercial Vehicle Group Inc
CVGW=Calavo Growers Inc
CVII=Churchill Capital Corp VII
CVIIU=Churchill Capital Corp VII Units
CVIIW=Churchill Capital Corp VII Warrants
CVKD=Cadrenal Therapeutics, Inc.
CVLG=Covenant Logistics Group, Inc.
CVLT=CommVault Systems Inc
CVLY=Codorus Valley Bancorp Inc
CVRX=CVRx, Inc.
CVV=CVD Equipment Corp
CWBC=Community West Bancshares
CWBR=Cohbar Inc
CWCO=Consolidated Water Co Ltd
CWD=CaliberCos Inc. - Class A Common Stock
CWST=Casella Waste Systems Inc
CXAI=Cxapp Inc
CXDO=Crexendo, Inc.
CYBR=CyberArk Software Ltd
CYCC=Cyclacel Pharmaceuticals Inc
CYCCP=Cyclacel Pharmaceuticals Inc
CYCN=Cyclerion Therapeutics Inc
CYN=CYNGN Inc.
CYRX=CryoPort Inc
CYT=Cyteir Therapeutics, Inc.
CYTH=Cyclo Therapeutics, Inc.
CYTHW=Cyclo Therapeutics, Inc.
CYTK=Cytokinetics Inc
CYTO=Altamira Therapeutics Ltd.
CZFS=Citizens Financial Services, Inc.
CZNC=Citizens & Northern Corp
CZR=Caesars Entertainment Corp
CZWI=Citizens Community Bancorp Inc-WI
DADA=Dada Nexus Ltd
DAIO=Data I-O Corp
DAKT=Daktronics Inc
DALN=DallasNews Corporation
DARE=Dare Bioscience Inc
DASH=DoorDash, Inc.
DATS=DatChat, Inc.
DATSW=DatChat, Inc.
DAVE=Famous Dave's of America Inc
DAVEW=Dave Inc.
DAWN=Day One Biopharmaceuticals, Inc.
DBGI=Digital Brands Group, Inc.
DBGIW=Digital Brands Group, Inc.
DBVT=DBV Technologies SA
DBX=Dropbox Inc
DCBO=Docebo Inc.
DCFC=Tritium DCFC Limited
DCFCW=Tritium DCFC Limited
DCGO=DocGo Inc.
DCOM=Dime Community Bancshares Inc
DCOMP=Dime Community Bancshares Inc
DCPH=Deciphera Pharmaceuticals Inc
DCTH=Delcath Systems, Inc.
DDI=DoubleDown Interactive Co Ltd
DDOG=Datadog Inc
DECA=Denali Capital Acquisition Corp.
DECAU=Denali Capital Acquisition Corp
DECAW=Denali Capital Acquisition Corp.
DENN=Denny's Corp
DERM=Dermira Inc
DFFN=Diffusion Pharmaceuticals Inc.
DFLI=Dragonfly Energy Holdings Corp
DFLIW=Dragonfly Energy Holdings Corp.
DGHI=Digihost Technology Inc.
DGICA=Donegal Group Inc
DGICB=Donegal Group Inc
DGII=Digi International Inc
DGLD=VelocityShares 3x Inverse Gold ETN linked to S&P GSCI Gold Index Excess Return
DGLY=Digital Ally Inc
DH=Definitive Healthcare Corp.
DHAC=Digital Health Acquisition Corp.
DHACU=Digital Health Acquisition Corp.
DHACW=Digital Health Acquisition Corp.
DHAI=DIH Holdings US, Inc. Class A Common Stock
DHAIW=DIH Holding US, Inc. Warrants
DHC=Diversified Healthcare Trust
DHCA=DHC Acquisition Corp.
DHCAU=DHC Acquisition Corp.
DHCAW=DHC Acquisition Corp.
DHCNI=Diversified Healthcare Trust
DHCNL=Diversified Healthcare Trust
DHIL=Diamond Hill Investment Group Inc
DIBS=1stdibs.com, Inc. Common Stock
DILAU=DILA Capital Acquisition Corp.
DIOD=Diodes Inc
DISCA=Discovery Inc
DIST=Distoken Acquisition Corporation - Ordinary Shares
DJCO=Daily Journal Corp
DJT=Trump Media & Technology Group Corp.
DJTWW=Trump Media & Technology Group Corp.
DKNG=DraftKings Inc
DLHC=DLH Holdings Corp
DLO=DLocal Limited
DLPN=Dolphin Entertainment Inc
DLTH=Duluth Holdings Inc
DLTR=Dollar Tree Inc
DMAC=DiaMedica Therapeutics Inc
DMAQ=Deep Medicine Acquisition Corp.
DMLP=Dorchester Minerals LP
DMRC=Digimarc Corp
DMTK=DermTech Inc
DNAA=Social Capital Suvretta Holdings Corp. I
DNAY=Codex DNA, Inc.
DNLI=Denali Therapeutics Inc
DNTH=Magenta Therapeutics Inc
DNUT=Krispy Kreme, Inc.
DOCU=DocuSign Inc
DOGZ=Dogness International Corp
DOMH=AIkido Pharma Inc.
DOMO=Domo Inc
DOOO=BRP Inc
DORM=Dorman Products Inc
DOX=Amdocs Ltd
DOYU=DouYu International Holdings Ltd
DPCS=DP Cap Acquisition Corp I
DPCSU=DP Cap Acquisition Corp I
DPCSW=DP Cap Acquisition Corp I
DPRO=Draganfly Inc.
DRAYW=Macondray Capital Acquisition C
DRCT=Direct Digital Holdings, Inc.
DRIO=DarioHealth Corp
DRMA=Dermata Therapeutics, Inc. Common Stock
DRMAW=Dermata Therapeutics, Inc.
DRRX=Durect Corp
DRS=Leonardo DRS, Inc.
DRTS=Alpha Tau Medical Ltd.
DRTSW=Alpha Tau Medical Ltd.
DRTT=DIRTT Environmental Solutions
DRUG=Bright Minds Biosciences Inc.
DSAC=Duddell Street Acquisition Corp.
DSGN=Design Therapeutics, Inc.
DSGR=Distribution Solutions Group, Inc.
DSGX=Descartes Systems Group Inc-The
DSKE=Daseke Inc
DSLV=VelocityShares 3x Inverse Silver ETN linked to S&P GSCI Silver Inverse Index
DSP=Viant Technology Inc.
DSWL=Deswell Industries Inc
DTCK=Davis Commodities Limited - Ordinary Shares
DTI=Drilling Tools International Corporation  - Common Stock
DTIL=Precision BioSciences Inc
DTOC=Digital Transformation Opportunities Corp.
DTSS=Datasea Inc
DTST=Data Storage Corp.
DTSTW=Data Storage Corporation
DUET=DUET Acquisition Corp.
DUETU=DUET Acquisition Corp
DUETW=DUET Acquisition Corp.
DUO=Fangdd Network Group Ltd
DUOL=Duolingo, Inc.
DUOT=Duos Technologies Group Inc
DVAX=Dynavax Technologies Corp
DWAC=Digital World Acquisition Corp.
DWACU=Digital World Acquisition Corp.
DWACW=Digital World Acquisition Corp.
DWSN=Dawson Geophysical Co
DXCM=DexCom Inc
DXLG=Destination XL Group Inc
DXPE=DXP Enterprises Inc-TX
DXR=Daxor Corp
DXYN=Dixie Group Inc-The
DYAI=Dyadic International Inc
DYCQ=DT Cloud Acquisition Corporation Ordinary Shares
DYCQR=DT Cloud Acquisition Corporation Right
DYCQU=DT CLOUD ACQUISITION CORPORATION UNIT 1 SH & 1 RT TO RECEIVE 1/7 ORD SH
DYFI=IDX Dynamic Fixed Income ETF
DYN=Dyne Therapeutics Inc
DYNT=Dynatronics Corp
DZSI=DASAN Zhone Solutions Inc
EA=Electronic Arts Inc
EAC=Edify Acquisition Corp.
EACPU=Edify Acquisition Corp.
EACPW=Edify Acquisition Corp.
EAST=Eastside Distilling Inc
EBAY=eBay Inc
EBC=Eastern Bankshares, Inc.
EBMT=Eagle Bancorp Montana Inc
EBON=Ebang International Holdings Inc
EBTC=Enterprise Bancorp Inc-MA
ECBK=ECB Bancorp, Inc.
ECDA=ECD Automotive Design, Inc.
ECDAW=ECD Automotive Design, Inc.
ECOR=ElectroCore Inc
ECPG=Encore Capital Group Inc
ECX=ECARX Holdings Inc.
ECXWW=ECARX Holdings Inc. Warrants
EDAP=EDAP TMS SA
EDBL=Edible Garden AG Incorporated
EDBLW=Edible Garden AG Incorporated
EDIT=Editas Medicine Inc
EDNC=Endurance Acquisition Corp.
EDRY=EuroDry Ltd
EDSA=Edesa Biotech Inc
EDTK=Skillful Craftsman Education Technology Limited
EDUC=Educational Development Corp
EEFT=Euronet Worldwide Inc
EEIQ=Elite Education Group International Limited
EFOI=Energy Focus Inc
EFSC=Enterprise Financial Services Corp
EFSCP=Enterprise Financial Services Corp
EFTR=eFFECTOR Therapeutics, Inc.
EFTRW=eFFECTOR Therapeutics, Inc.
EGAN=eGain Corp
EGBN=Eagle Bancorp Inc
EGHT=8x8 Inc
EGIO=Edgio Inc
EGOX=Next.e.GO N.V.
EGRX=Eagle Pharmaceuticals Inc-DE
EH=EHang Holdings Ltd
EHTH=eHealth Inc
EIGR=Eiger BioPharmaceuticals Inc
EJH=E-Home Household Service Holdings Limited
EKSO=Ekso Bionics Holdings Inc
ELAB=Elevai Labs, Inc.
ELBM=Electra Battery Materials Corporation
ELDN=Eledon Pharmaceuticals, Inc.
ELEV=Elevation Oncology, Inc.
ELMS=Electric Last Mile Solutions, Inc.
ELMSW=Electric Last Mile Solutions, I
ELSE=Electro-Sensors Inc
ELTK=Eltek Ltd
ELTX=Elicio Therapeutics, Inc. - Common Stock
ELUT=Elutia Inc
ELVA=Electrovaya Inc. - Common Shares
ELVN=Enliven Therapeutics, Inc.  - Common Stock
ELYM=Eliem Therapeutics, Inc.
EM=Smart Share Global Limited
EMBC=Embecta Corp.
EMCGR=Embrace Change Acquisition Corp.
EMCGU=Embrace Change Acquisition Corp
EMCGW=Embrace Change Acquisition Corp.
EMKR=EMCORE Corp
EML=Eastern Co-The
EMLD=FTAC Emerald Acquisition Corp.
EMLDU=FTAC Emerald Acquisition Corp. Unit
EMLDW=FTAC Emerald Acquisition Corp.
ENCP=Energem Corp.
ENCPU=Energem Corp.
ENCPW=Energem Corp.
ENERW=Accretion Acquisition Corp.
ENG=ENGlobal Corp
ENGN=enGene Holdings Inc.
ENGNW=enGene Holdings Inc.
ENLT=Enlight Renewable Energy Ltd.
ENLV=Enlivex Therapeutics Ltd
ENOB=Enochian Biosciences, Inc.
ENPH=Enphase Energy Inc
ENSC=Ensysce Biosciences, Inc.
ENSG=Ensign Group Inc-The
ENTA=Enanta Pharmaceuticals Inc
ENTG=Entegris Inc
ENTX=Entera Bio Ltd
ENVB=Enveric Biosciences, Inc.
ENVX=Enovix Corporation
EOLS=Evolus Inc
EOSE=Eos Energy Enterprises Inc
EOSEW=Eos Energy Enterprises, Inc.
EPIX=Essa Pharma Inc
EPOW=
EPRX=Eupraxia Pharmaceuticals Inc.
EPRXF=EUPRAXIA PHARMACEUTICALS INC
EPSN=Epsilon Energy Ltd-Canada
EQ=Equillium Inc
EQIX=Equinix Inc
EQRXW=EQRx, Inc.
ERAS=Erasca, Inc.
ERIC=Telefonaktiebolaget LM Ericsson
ERIE=Erie Indemnity Co
ERII=Energy Recovery Inc
ERNA=Eterna Therapeutics Inc.
ESAC=ESGEN Acquisition Corporation Class A Ordinary Shares
ESACU=ESGEN Acquisition Corporation
ESACW=ESGEN Acquisition Corporation
ESCA=Escalade Inc
ESEA=Euroseas Ltd
ESGR=Enstar Group Ltd
ESGRO=Enstar Group Ltd
ESGRP=Enstar Group Ltd
ESHA=ESH Acquisition Corp. - Class A Common Stock
ESLA=Estrella Immunopharma Inc
ESLT=Elbit Systems Ltd
ESOA=Energy Services of America Corp.
ESPR=Esperion Therapeutics Inc
ESQ=Esquire Financial Holdings Inc
ESSA=ESSA Bancorp Inc
ESSC=East Stone Acquisition Corp
ESTA=Establishment Labs Holdings Inc
ETAO=Etao International Co., Ltd. - Ordinary Shares
ETNB=89bio Inc
ETON=Eton Pharmaceuticals Inc
ETSY=Etsy Inc
ETTX=Entasis Therapeutics Holdings Inc
EUDA=Euda Health Holdings Limited
EUDAW=EUDA Health Holdings Limited
EVAX=Evaxion Biotech A/S
EVBG=Everbridge Inc
EVCM=EverCommerce Inc.
EVER=EverQuote Inc
EVFM=Evofem Biosciences Inc
EVGN=Evogene Ltd
EVGO=EVgo, Inc.
EVGOW=EVgo, Inc.
EVGR=Evergreen Corp
EVGRU=Evergreen Corp
EVGRW=Evergreen Corporation
EVLO=Evelo Biosciences Inc
EVLV=2
EVLVW=Evolv Technologies Holdings, Inc.
EVO=Evotec SE
EVOK=Evoke Pharma Inc
EVOL=Evolving Systems Inc
EVRG=Evergy Inc
EVTV=Envirotech Vehicles, Inc.
EWBC=East West Bancorp Inc
EWCZ=European Wax Center, Inc.
EWTX=Edgewise Therapeutics, Inc.
EXAI=Exscientia plc
EXAS=Exact Sciences Corp
EXC=Exelon Corp
EXEL=Exelixis Inc
EXFY=Expensify, Inc.
EXLS=ExlService Holdings Inc
EXPE=Expedia Group Inc
EXPI=eXp World Holdings Inc
EXPO=Exponent Inc
EXTR=Extreme Networks Inc
EYE=National Vision Holdings Inc
EYEG=EyeGate Pharmaceuticals Inc
EYEN=Eyenovia Inc
EYES=Second Sight Medical Products Inc
EYPT=EyePoint Pharmaceuticals Inc
EZFL=EZFill Holdings Inc.
EZGO=EZGO Technologies Ltd.
EZPW=EZCORP Inc
FA=First Advantage Corporation
FAAS=DigiAsia Corp.
FAASW=DigiAsia Corp.
FAMI=Farmmi Inc
FANG=Diamondback Energy Inc
FANH=Fanhua Inc
FARM=Farmer Brothers Co
FARO=FARO Technologies Inc
FAST=Fastenal Co
FAT=FAT Brands Inc
FATBB=FAT Brands Inc.
FATBP=FAT Brands Inc.
FATBW=FAT Brands Inc.
FATE=Fate Therapeutics Inc
FATPU=Fat Projects Acquisition Corp
FATPW=Fat Projects Acquisition Corp
FAZEW=FaZe Holdings Inc.
FBIO=Fortress Biotech Inc
FBIOP=Fortress Biotech Inc
FBIZ=First Business Financial Services Inc
FBLG=FibroBiologics, Inc. Common Stock
FBMS=First Bancshares Inc-The
FBNC=First Bancorp-Southern Pines NC
FBRX=Forte Biosciences, Inc.
FBYD=Falcon's Beyond Global, Inc. - Class A Common Stock
FCAP=First Capital Inc
FCBC=First Community Bankshares Inc
FCCO=First Community Corp-SC
FCEL=FuelCell Energy Inc
FCFS=FirstCash Inc
FCNCA=First Citizens BancShares Inc-NC
FCNCO=First Citizens BancShares, Inc. - 5.625% Non-Cumulative Perpetual Preferred Stock, Series C
FCNCP=First Citizens BancShares Inc-NC
FCUV=Focus Universal, Inc.
FDBC=Fidelity D&D Bancorp Inc
FDMT=4D Molecular Therapeutics, Inc.
FDUS=Fidus Investment Corp
FEAM=5E Advanced Materials, Inc.
FEBO=Fenbo Holdings Limited
FEIM=Frequency Electronics Inc
FELE=Franklin Electric Co Inc
FEMY=Femasys Inc.
FENC=Fennec Pharmaceuticals Inc
FEXD=Fintech Ecosystem Development Corp.
FEXDR=Fintech Ecosystem Development Corp.
FEXDU=Fintech Ecosystem Development Corp.
FEXDW=Fintech Ecosystem Development Corp.
FFBC=First Financial Bancorp
FFBW=FFBW Inc
FFHL=Fuwei Films Holdings Co Ltd
FFIC=Flushing Financial Corp
FFIE=Faraday Future Intelligent Electric Inc.
FFIEW=Faraday Future Intelligent Electric Inc.
FFIN=First Financial Bankshares Inc
FFIV=F5 Networks Inc
FFNW=First Financial Northwest Inc
FGBI=First Guaranty Bancshares Inc
FGBIP=First Guaranty Bancshares, Inc.
FGEN=FibroGen Inc
FGF=FG Financial Group, Inc.
FGFPP=FG Financial Group, Inc.
FGI=FGI Industries Ltd.
FGIWW=FGI Industries Ltd.
FGMC=FG Merger Corp.
FGMCW=FG Merger Corp.
FHB=First Hawaiian Inc
FHLT=Future Health ESG Corp.
FHLTU=Future Health ESG Corp.
FHLTW=Future Health ESG Corp.
FHTX=Foghorn Therapeutics Inc
FIAC=Focus Impact Acquisition Corp.
FIACU=Focus Impact Acquisition Corp.
FIACW=Focus Impact Acquisition Corp.
FIBK=First Interstate BancSystem Inc
FINW=FinWise Bancorp
FIP=FTAI Infrastructure LLC
FISI=Financial Institutions Inc
FISV=Fiserv, Inc.
FITB=Fifth Third Bancorp
FITBI=Fifth Third Bancorp
FITBO=Fifth Third Bancorp
FITBP=Fifth Third Bancorp
FIVE=Five Below Inc
FIVN=Five9 Inc
FIXX=Homology Medicines Inc
FIZZ=National Beverage Corp
FKWL=Franklin Wireless Corp.
FLAC=Frazier Lifesciences Acquisition Corporation
FLDB=Fidelity Low Duration Bond ETF
FLEX=Flex Ltd
FLFV=Feutune Light Acquisition Corporation
FLFVR=Feutune Light Acquisition Corporation
FLFVU=Feutune Light Acquisition Corp
FLFVW=Feutune Light Acquisition Corporation
FLGC=Flora Growth Corp.
FLGT=Fulgent Genetics Inc
FLIC=First of Long Island Corp-The
FLJ=FLJ Group Limited
FLL=Full House Resorts Inc
FLNC=Fluence Energy, Inc.
FLNT=Fluent Inc
FLUX=Flux Power Holdings, Inc.
FLWS=1-800-Flowers.com Inc
FLXS=Flexsteel Industries Inc
FLYW=Flywire Corporation
FMAO=Farmers & Merchants Bancorp Inc-Archbold OH
FMBH=First Mid Bancshares Inc
FMNB=Farmers National Banc Corp
FMST=Foremost Lithium Resource & Technology Ltd. - Common stock
FNCB=FNCB Bancorp Inc
FNCH=Finch Therapeutics Group, Inc.
FNGR=FingerMotion, Inc.
FNKO=Funko Inc
FNLC=First Bancorp Inc-ME
FNVT=Finnovate Acquisition Corp.
FNVTU=Finnovate Acquisition Corp.
FNVTW=Finnovate Acquisition Corp.
FNWB=First Northwest Bancorp
FNWD=Finward Bancorp
FOLD=Amicus Therapeutics Inc
FONR=FONAR Corp
FORA=Forian Inc.
FORD=Forward Industries Inc
FORL=Four Leaf Acquisition Corporation - Class A Common Stock
FORM=FormFactor Inc
FORR=Forrester Research Inc
FORTY=Formula Systems 1985 Ltd
FOSL=Fossil Group Inc
FOSLL=Fossil Group, Inc. 7% Senior Notes due 2026
FOX=Fox Corp
FOXA=Fox Corp
FOXF=Fox Factory Holding Corp
FPAY=FlexShopper Inc
FRAF=Franklin Financial Services Corp
FRBA=First Bank-Hamilton NJ
FREE=Whole Earth Brands, Inc.
FREEW=Whole Earth Brands Inc
FRES=Fresh2 Group Ltd.
FRGT=Freight Technologies Inc
FRHC=Freedom Holding Corp-NV
FRLA=Fortune Rise Acquisition Corp.
FRLAW=Fortune Rise Acquisition Corp.
FRME=First Merchants Corp
FRMEP=First Merchants Corporation - Depository Shares, each representing a 1/100th interest in a share of 7.50% Non-Cumulative Perpetual Preferred Stock, A
FROG=JFrog Ltd
FRPH=FRP Holdings Inc
FRPT=Freshpet Inc
FRSGW=First Reserve Sustainable Growt
FRSH=Freshworks Inc.
FRST=Primis Financial Corp.
FRSX=Foresight Autonomous Holdings Ltd
FRTX=Fresh Tracks Therapeutics Inc
FRWAW=PWP Forward Acquisition Corp. I
FRZA=Forza X1, Inc.
FSBC=FSB Bancorp Inc-NY
FSBW=FS Bancorp Inc
FSEA=First Seacoast Bancorp
FSFG=First Savings Financial Group Inc
FSLR=First Solar Inc
FSTR=LB Foster Co
FSV=FirstService Corp
FTAAU=FTAC Athena Acquisition Corp.
FTAI=Fortress Transportation & Infrastructure Investors LLC
FTAIN=Fortress Transportation and Infrastructure Investors LLC
FTAIO=Fortress Transportation and Infrastructure Investors LLC
FTAIP=Fortress Transportation and Infrastructure Investors LLC
FTCI=FTC Solar, Inc.
FTDR=frontdoor Inc
FTEK=Fuel Tech Inc
FTEL=Fitell Corporation - Ordinary Shares
FTFT=Future FinTech Group Inc
FTHM=Fathom Holdings Inc.
FTII=FutureTech II Acquisition Corp.
FTIIU=FutureTech II Acquisition Corp
FTIIW=FutureTech II Acquisition Corp.
FTLF=FitLife Brands, Inc.
FTNT=Fortinet Inc
FTPAW=FTAC Parnassus Acquisition Corp
FTRE=Fortrea Holdings Inc. - Common Stock
FUFU=BitFuFu Inc.
FUFUW=BitFuFu Inc.
FULC=Fulcrum Therapeutics Inc
FULT=Fulton Financial Corp
FULTP=Fulton Financial Corporation
FUNC=First United Corp
FUSB=First US Bancshares Inc
FUSN=Fusion Pharmaceuticals Inc
FUTU=Futu Holdings Ltd
FUV=Arcimoto Inc
FVAM=5:01 Acquisition Corp.
FVCB=FVCBankcorp Inc
FWBI=First Wave BioPharma, Inc.
FWONA=Liberty Media Corp-Liberty Formula One
FWONK=Liberty Media Corp-Liberty Formula One
FWRD=Forward Air Corp
FWRG=First Watch Restaurant Group, Inc.
FXNC=First National Corp-VA
FYBR=Frontier Communications Parent, Inc.
GABC=German American Bancorp Inc
GAIA=Gaia Inc
GAIN=Gladstone Investment Corp
GAINN=Gladstone Investment Corporation 5.00% Notes Due 2026
GAINZ=Gladstone Investment Corporation 4.875% Notes due 2028
GALT=Galectin Therapeutics Inc
GAMB=Gambling.com Group Limited
GAMC=Golden Arrow Merger Corp.
GAMCU=Golden Arrow Merger Corp.
GAME=Engine Media Holdings, Inc.
GAN=GAN Ltd
GANX=Gain Therapeutics, Inc.
GAQ=Generation Asia I Acquisition Limited
GASS=StealthGas Inc
GATE=Marblegate Acquisition Corp.
GATEU=Marblegate Acquisition Corp.
GATEW=Marblegate Acquisition Corp.
GBBK=Global Blockchain Acquisition Corp.
GBBKR=Global Blockchain Acquisition Corp.
GBBKW=Global Blockchain Acquisition Corp.
GBDC=Golub Capital BDC Inc
GBIO=Generation Bio Co
GBNH=Greenbrook TMS Inc.
GBNY=Generations Bancorp NY, Inc.
GBOX=GreenBox POS
GBS=GBS Inc.
GCBC=Greene County Bancorp Inc
GCMG=GCM Grosvenor Inc
GCMGW=GCM Grosvenor Inc.
GCT=GigaCloud Technology Inc
GCTK=GlucoTrack, Inc.
GDC=Code Chain New Continent Limited
GDEN=Golden Entertainment Inc
GDEV=Nexters Inc.
GDEVW=Nexters Inc.
GDHG=Golden Heaven Group Holdings Ltd.  - Ordinary shares
GDRX=GoodRx Holdings Inc
GDS=GDS Holdings Ltd
GDST=Goldenstone Acquisition Limited
GDSTR=Goldenstone Acquisition Limited
GDSTU=Goldenstone Acquisition Ltd
GDSTW=Goldenstone Acquisition Limited
GDTC=CytoMed Therapeutics Limited - Ordinary Shares
GDYN=Grid Dynamics Holdings Inc
GECC=Great Elm Capital Corp
GECCI=Great Elm Capital Corp. 8.50% NOTES DUE 2029
GECCM=Great Elm Capital Corp. - 6.75%
GECCO=Great Elm Capital Corp. 5.875% Notes due 2026
GEG=Great Elm Group, Inc.
GEGGL=Great Elm Group, Inc. - 7.25% Notes due 2027
GEHC=GE HealthCare Technologies Inc.
GEN=Gen Digital Inc.
GENE=Genetic Technologies Ltd
GENK=GEN Restaurant Group, Inc. - Class A Common Stock
GEOS=Geospace Technologies Corp
GERN=Geron Corp
GEVO=Gevo Inc
GFAI=Guardforce AI Co., Limited
GFAIW=Guardforce AI Co., Limited
GFS=GLOBALFOUNDRIES Inc.
GGAL=Grupo Financiero Galicia SA
GGE=Green Giant Inc
GGMCW=Glenfarne Merger Corp.
GGPIW=Gores Guggenheim, Inc.
GGR=Gogoro Inc.
GGROW=Gogoro Inc.
GH=Guardant Health Inc
GHACU=Gaming & Hospitality Acquisition Corp.
GHIX=Gores Holdings IX, Inc.
GHIXU=Gores Holdings IX Inc
GHIXW=Gores Holdings IX, Inc.
GHRS=GH Research PLC
GHSI=Guardion Health Sciences Inc
GIA=GigCapital 5, Inc.
GIAC=Gesher I Acquisition Corp.
GIFI=Gulf Island Fabrication Inc
GIGM=GigaMedia Ltd
GIII=G-III Apparel Group Ltd
GILD=Gilead Sciences Inc
GILT=Gilat Satellite Networks Ltd
GIPR=Generation Income Properties Inc.
GIPRW=Generation Income Properties, Inc.
GIWWW=GigInternational1, Inc.
GLAC=Greenland Acquisition Corp
GLACR=Global Lights Acquisition Corp
GLACU=Greenland Acquisition Corp
GLAD=Gladstone Capital Corp
GLBE=Global-e Online Ltd.
GLBL=Cartesian Growth Corporation
GLBS=Globus Maritime Ltd
GLBZ=Glen Burnie Bancorp
GLDD=Great Lakes Dredge & Dock Corp
GLDI=Credit Suisse X-Links Gold Shares Covered Call ETN
GLHAW=Glass Houses Acquisition Corp.
GLLI=Globalink Investment Inc.
GLLIR=Globalink Investment Inc.
GLLIU=Globalink Investment Inc. Unit
GLLIW=Globalink Investment Inc.
GLMD=Galmed Pharmaceuticals Ltd
GLNG=Golar LNG Ltd
GLPG=Galapagos NV
GLPI=Gaming and Leisure Properties Inc
GLRE=Greenlight Capital Re Ltd
GLSI=Greenwich LifeSciences, Inc.
GLST=Global Star Acquisition, Inc.
GLSTR=Global Star Acquisition, Inc. Right
GLSTU=Global Star Acquisition Inc
GLSTW=Global Star Acquisition, Inc.
GLTO=Galecto Inc
GLUE=Monte Rosa Therapeutics, Inc.
GLYC=GlycoMimetics Inc
GMAB=Genmab A/S 
GMDA=Gamida Cell Ltd
GMFI=Aetherium Acquisition Corp.
GMFIU=Aetherium Acquisition Corp
GMFIW=Aetherium Acquisition Corp.
GMGI=Golden Matrix Group, Inc.
GMM=Global Mofy Metaverse Limited - Ordinary Shares
GMTX=Gemini Therapeutics, Inc.
GNFT=Genfit
GNLN=Greenlane Holdings Inc
GNLX=GENELUX CORPORATION
GNOG=Golden Nugget Online Gaming, Inc.
GNPX=Genprex Inc
GNSS=Genasys Inc
GNTA=Genenta Science S.p.A. American Depositary Shares
GNTX=Gentex Corp
GO=Grocery Outlet Holding Corp
GOCO=GoHealth Inc
GODN=Golden Star Acquisition Corporation - Ordinary Shares
GOEV=Canoo Holdings Ltd.
GOEVW=Canoo Holdings Ltd.
GOGL=Golden Ocean Group Ltd
GOGO=Gogo Inc
GOOD=Gladstone Commercial Corp
GOODN=Gladstone Commercial Corp
GOODO=Gladstone Commercial Corp
GOOG=Alphabet Inc
GOOGL=Alphabet Inc
GORV=Lazydays Holdings Inc
GOSS=Gossamer Bio Inc
GOVX=GeoVax Labs, Inc.
GOVXW=GeoVax Labs, Inc.
GP=GreenPower Motor Company Inc.
GPAC=Global Partner Acquisition Corp II
GPACU=Global Partner Acquisition Corp II
GPACW=Global Partner Acquisition Corp II
GPAK=Gamer Pakistan Inc. - Common Stock
GPCO=Golden Path Acquisition Corporation
GPCOR=Golden Path Acquisition Corpora
GPRE=Green Plains Inc
GPRO=GoPro Inc
GRAB=Grab Holdings Limited Class A Ordinary Shares
GRABW=Grab Holdings Limited
GRDI=GRIID Infrastructure Inc. Common Stock
GRDIW=GRIID Infrastructure Inc. Warrant
GREE=Greenidge Generation Holdings Inc.
GREEL=Greenidge Generation Holdings Inc. 8.50% Senior Notes due 2026
GRFS=Grifols SA
GRIN=Grindrod Shipping Holdings Ltd
GRNQ=Greenpro Capital Corp
GROM=Grom Social Enterprises, Inc.
GROMW=Grom Social Enterprises, Inc.
GROW=US Global Investors Inc
GRPH=Graphite Bio, Inc.
GRPN=Groupon Inc
GRRR=Gorilla Technology Group Inc.
GRRRW=Gorilla Technology Group Inc.
GRTS=Gritstone Oncology Inc
GRTX=Galera Therapeutics Inc
GRVI=Grove, Inc.
GRVY=Gravity Co Ltd
GRWG=GrowGeneration Corp
GRYP=Gryphon Digital Mining, Inc
GSBC=Great Southern Bancorp Inc
GSD=Global Systems Dynamics Inc.
GSHD=Goosehead Insurance Inc
GSIT=GSI Technology Inc
GSIW=Garden Stage Limited
GSM=Ferroglobe PLC
GSMGW=Glory Star New Media Group Holdings Limited
GSUN=Golden Sun Education Group Limited
GT=Goodyear Tire & Rubber Co-The
GTAC=Global Technology Acquisition Corp. I Class A Ordinary Shares
GTACU=Global Technology Acquisition Corp. I
GTACW=Global Technology Acquisition Corp. I
GTBP=GT Biopharma Inc.
GTEC=Greenland Technologies Holding
GTH=Genetron Holdings Ltd
GTHX=G1 Therapeutics Inc
GTI=Energem Corp
GTIM=Good Times Restaurants Inc
GTLB=GitLab Inc.
GTPAW=Gores Technology Partners, Inc.
GTPBW=Gores Technology Partners II, I
GTX=Garrett Motion Inc
GURE=Gulf Resources Inc
GUTS=Fractyl Health, Inc. Common Stock
GV=Goldfield Corp-The
GVH=Globavend Holdings Limited
GVP=GSE Systems Inc
GWAV=Greenwave Technology Solutions, Inc.
GWRS=Global Water Resources Inc
GXAI=The NFT Gaming Company, Inc.
GXIIW=GX Acquisition Corp. II
GYRE=Gyre Therapeutics, Inc.
GYRO=Gyrodyne LLC
HA=Hawaiian Holdings Inc
HAACU=Health Assurance Acquisition Corp.
HAFC=Hanmi Financial Corp
HAIA=Healthcare AI Acquisition Corp.
HAIAU=Healthcare AI Acquisition Corp. Unit
HAIAW=Healthcare AI Acquisition Corp.
HAIN=Hain Celestial Group Inc-The
HALL=Hallmark Financial Services Inc
HALO=Halozyme Therapeutics Inc
HAS=Hasbro Inc
HAYN=Haynes International Inc
HBAN=Huntington Bancshares Inc-OH
HBANM=Huntington Bancshares Incorporated
HBANP=Huntington Bancshares Incorporated Depositary Shares 4.500% Series H Non-Cumulative Perpetual Preferred Stock
HBCP=Home Bancorp Inc
HBIO=Harvard Bioscience Inc
HBNC=Horizon Bancorp Inc-IN
HBT=HBT Financial Inc
HCAT=Health Catalyst Inc
HCDIW=Harbor Custom Development, Inc.
HCDIZ=Harbor Custom Development, Inc.
HCKT=Hackett Group Inc-The
HCM=Hutchison China MediTech Ltd
HCMA=HCM Acquisition Corp
HCMAU=HCM ACQUISITION CORP
HCMAW=HCM Acquisition Corp
HCP=HashiCorp, Inc.
HCSG=Healthcare Services Group Inc
HCTI=Hybrid Coating Technologies, Inc.
HCVI=Hennessy Capital Investment Corp. VI
HCVIU=Hennessy Capital Investment Corp. VI
HCVIW=Hennessy Capital Investment Corp. VI
HCWB=HCW Biologics Inc.
HDSN=Hudson Technologies Inc
HEAR=Turtle Beach Corp
HEES=H&E Equipment Services Inc
HELE=Helen of Troy Ltd
HEPA=Hepion Pharmaceuticals Inc
HEPS=D-MARKET Elektronik Hizmetler ve Ticaret Anonim Sirketi
HERAW=FTAC Hera Acquisition Corp.
HFBL=Home Federal Bancorp Inc-LA
HFFG=HF Foods Group Inc
HFWA=Heritage Financial Corp-WA
HGAS=Global Gas Corporation
HGASW=Global Gas Corporation
HGBL=Heritage Global Inc.
HHGC=HHG Capital Corporation
HHGCR=HHG Capital Corporation
HHGCU=HHG Capital Corporation
HHGCW=HHG Capital Corporation
HHS=Harte-Hanks Inc
HIBB=Hibbett Sports Inc
HIFS=Hingham Institution for Savings
HIHO=Highway Holdings Ltd
HILS=Hillstream BioPharma, Inc.
HIMX=Himax Technologies Inc
HITI=High Tide Inc.
HIVE=Aerohive Networks Inc
HJLI=Hancock Jaffe Laboratories Inc
HLIT=Harmonic Inc
HLMN=Hillman Solutions Corp.
HLNE=Hamilton Lane Inc
HLP=Hongli Group Inc. - Ordinary Shares
HLTH=Nobilis Health Corp
HLVX=HilleVax, Inc.
HLXB=Helix Acquisition Corp. II Class A Ordinary Shares
HMNF=HMN Financial Inc
HMST=HomeStreet Inc
HNNA=Hennessy Advisors Inc
HNNAZ=Hennessy Advisors, Inc. 4.875% Notes due 2026
HNRG=Hallador Energy Co
HNST=The Honest Company, Inc.
HNVR=Hanover Bancorp, Inc.
HOFT=Hooker Furniture Corp
HOFV=Hall of Fame Resort & Entertainment Company
HOFVW=Hall of Fame Village, LLC
HOLI=Hollysys Automation Technologies Ltd
HOLO=MicroCloud Hologram Inc.
HOLOW=MicroCloud Hologram Inc.
HOLX=Hologic Inc
HON=Honeywell International Inc
HONE=HarborOne Bancorp Inc
HOOD=Robinhood Markets, Inc.
HOOK=Hookipa Pharma Inc
HOPE=Hope Bancorp Inc
HOTH=Hoth Therapeutics Inc
HOUR=Hour Loop, Inc.
HOVNP=Hovnanian Enterprises Inc
HOVR=New Horizon Aircraft Ltd.
HOVRW=Pono Capital Three, Inc.
HOWL=Werewolf Therapeutics, Inc.
HPCO=Hempacco Co Inc
HPH=Highest Performances Holdings Inc.
HPK=HighPeak Energy, Inc.
HPKEW=HighPeak Energy, Inc.
HQI=HireQuest Inc
HQY=HealthEquity Inc
HRMY=Harmony Biosciences Holdings, Inc.
HROW=Harrow Health Inc
HROWL=Harrow Health, Inc. 8.625% Senior Notes due 2026
HROWM=Harrow Health, Inc. - 11.875% Senior Notes due 2027
HRTX=Heron Therapeutics Inc
HRYU=Hanryu Holdings, Inc. - Common Stock
HRZN=Horizon Technology Finance Corp
HSAQ=Health Sciences Acquisitions Corporation 2
HSCS=Heart Test Laboratories, Inc.
HSCSW=Heart Test Laboratories, Inc.
HSDT=Helius Medical Technologies Inc
HSIC=Henry Schein Inc
HSII=Heidrick & Struggles International Inc
HSON=Hudson Global Inc
HSPO=HORIZON SPACE ACQUISITION I CORP
HSPOR=Horizon Space Acquisition I Corp. Right
HSPOU=HORIZON SPACE ACQUISITION I CORP UNIT 1 ORD 1 WT & 1 RT
HSPOW=Horizon Space Acquisition I Corp. Warrant
HST=Host Hotels & Resorts Inc
HSTM=HealthStream Inc
HTBI=HomeTrust Bancshares Inc
HTBK=Heritage Commerce Corp
HTCR=HeartCore Enterprises, Inc.
HTHT=Huazhu Group Ltd
HTIA=Healthcare Trust Inc
HTIBP=Healthcare Trust, Inc.
HTLD=Heartland Express Inc
HTLF=Heartland Financial USA Inc
HTLFP=Heartland Financial USA, Inc.
HTOO=Fusion Fuel Green PLC
HTOOW=Fusion Fuel Green PLC
HTZ=Hertz Global Holdings Inc
HTZWW=Hertz Global Holdings, Inc.
HUBC=Hub Cyber Security Ltd. - Ordinary Shares
HUBG=Hub Group Inc
HUDA=HUDSON ACQUISITION I CORP
HUDAR=Hudson Acquisition I Corp.
HUDAU=Hudson Acquisition I Corp.
HUDI=Huadi International Group Co., Ltd.
HUGE=FSD Pharma Inc
HUIZ=Huize Holding Ltd
HUMA=Humacyte, Inc.
HUMAW=Humacyte, Inc.
HURC=Hurco Cos Inc
HURN=Huron Consulting Group Inc
HUSN=Hudson Capital Inc.
HUT=Hut 8 Mining Corp.
HWBK=Hawthorn Bancshares Inc
HWC=Hancock Whitney Corp
HWCPZ=Hancock Whitney Corporation - 6
HWELW=Healthwell Acquisition Corp. I
HWH=HWH International Inc
HWKN=Hawkins Inc
HX=Hexindai Inc
HYFM=Hydrofarm Holdings Group, Inc.
HYMC=Hycroft Mining Holding Corporation
HYMCL=Hycroft Mining Holding Corporation
HYMCW=Hycroft Mining Holding Corporation
HYPR=Hyperfine, Inc.
HYW=Hywin Holdings Ltd.
HYXF=iShares ESG Advanced High Yield Corporate Bond ETF
HYZN=Hyzon Motors Inc.
HYZNW=HYZON Motors Inc
IAC=IAC-InterActiveCorp
IART=Integra LifeSciences Holdings Corp
IAS=Integral Ad Science Holding Corp.
IBACU=IB Acquisition Corp.
IBCP=Independent Bank Corp-MI
IBEX=Ibex Ltd
IBKR=Interactive Brokers Group Inc
IBOC=International Bancshares Corp
IBRX=ImmunityBio, Inc.
IBTX=Independent Bank Group Inc
ICAD=Icad Inc
ICCC=ImmuCell Corp
ICCH=ICC Holdings Inc
ICCM=IceCure Medical Ltd
ICCT=iCoreConnect, Inc.
ICFI=ICF International Inc
ICHR=Ichor Holdings Ltd
ICLK=iClick Interactive Asia Group Ltd
ICLR=ICON PLC
ICMB=Investcorp Credit Management BDC Inc
ICU=SeaStar Medical Holding Corporation
ICUCW=SeaStar Medical Holding Corporation
ICUI=ICU Medical Inc
IDAI=T Stamp Inc.
IDCC=InterDigital Inc
IDEX=Ideanomics Inc
IDN=Intellicheck Inc
IDXX=IDEXX Laboratories Inc
IDYA=Ideaya Biosciences Inc
IEP=Icahn Enterprises LP
IESC=IES Holdings Inc
IFBD=Infobird Co., Ltd
IFRX=InflaRx NV
IGIC=International General Insurance Holdings Ltd Bermuda
IGLD=Internet Gold-Golden Lines Ltd
IGMS=IGM Biosciences Inc
IGTA=Inception Growth Acquisition Limited
IGTAR=Inception Growth Acquisition Limited
IGTAU=Inception Growth Acquisition Limited
IGTAW=Inception Growth Acquisition Limited
IHRT=iHeartMedia Inc
III=Information Services Group Inc
IIIV=I3 Verticals Inc
IINN=Inspira Technologies Oxy B.H.N. Ltd.
IINNW=Inspira Technologies Oxy B.H.N. Ltd.
IKNA=Ikena Oncology, Inc.
IKT=Inhibikase Therapeutics Inc
ILAG=Intelligent Living Application Group Inc.
ILMN=Illumina Inc
ILPT=Industrial Logistics Properties Trust
IMAB=I-Mab
IMAQ=International Media Acquisition Corp.
IMAQR=International Media Acquisition Corp.
IMAQU=International Media Acquisition Corp.
IMAQW=International Media Acquisition Corp.
IMCC=IM Cannabis Corp.
IMCR=Immunocore Holdings plc
IMKTA=Ingles Markets Inc
IMMP=Immutep Ltd
IMMR=Immersion Corp
IMMX=Immix Biopharma, Inc. Common Stock
IMNM=Immunome Inc
IMNN=Imunon, Inc.
IMOS=ChipMOS Technologies Inc
IMPP=Imperial Petroleum Inc.
IMPPP=Imperial Petroleum Inc. - 8.75%
IMRN=Immuron Ltd
IMRNW=Immuron Limited
IMRX=Immuneering Corporation
IMTE=Integrated Media Technology Ltd
IMTX=Immatics N.V.
IMTXW=immatics biotechnologies GmbH
IMUX=Immunic Inc
IMVT=Immunovant Inc
IMXI=International Money Express Inc
INAB=IN8bio Inc
INAQ=INSU Acquisition Corp. II
INAQU=Insight Acquisition Corp. /DE
INAQW=Insight Acquisition Corp.
INBK=First Internet Bancorp
INBKZ=First Internet Bancorp
INBS=Intelligent Bio Solutions Inc.
INBX=Inhibrx, Inc.
INCR=InterCure Ltd.
INCY=Incyte Corp
INDB=Independent Bank Corp-Rockland MA
INDI=indie Semiconductor, Inc.
INDP=Indaptus Therapeutics, Inc.
INDV=Indivior PLC - Ordinary Shares
INFN=Infinera Corp
INGN=Inogen Inc
INHD=Inno Holdings Inc.
INKT=MiNK Therapeutics, Inc.
INM=InMed Pharmaceuticals Inc.
INMB=Inmune Bio Inc
INMD=Inmode Ltd
INNV=Innovus Pharmaceuticals, Inc.
INO=Inovio Pharmaceuticals Inc
INOD=Innodata Inc
INPX=Inpixon
INSE=Inspired Entertainment Inc
INSG=Inseego Corp
INSM=Insmed Inc
INTA=Intapp, Inc.
INTC=Intel Corp
INTE=Integral Acquisition Corporation 1 Class A Common Stock
INTEU=Integral Acquisition Corporation 1
INTEW=Integral Acquisition Corporation 1
INTG=InterGroup Corp-The
INTJ=Intelligent Group Limited
INTR=Inter & Co, Inc.
INTS=Intensity Therapeutics, Inc. - Common Stock
INTU=Intuit Inc
INTZ=Intrusion, Inc.
INVA=Innoviva Inc
INVE=Identiv Inc
INVO=INVO BioScience, Inc.
INVZ=Innoviz Technologies Ltd.
INVZW=Innoviz Technologies Ltd.
INZY=Inozyme Pharma, Inc.
IOBT=IO Biotech, Inc.
IONM=Assure Holdings Corp.
IONR=ioneer Ltd
IONS=Ionis Pharmaceuticals Inc
IOSP=Innospec Inc
IOVA=Iovance Biotherapeutics Inc
IPA=ImmunoPrecise Antibodies Ltd.
IPAR=Inter Parfums Inc
IPDN=Professional Diversity Network Inc
IPGP=IPG Photonics Corp
IPHA=Innate Pharma SA
IPIC=iPic Entertainment Inc
IPSC=2
IPW=iPower Inc.
IPWR=Ideal Power Inc
IPX=IperionX Limited
IPXX=Inflection Point Acquisition Corp. II - Class A Ordinary Shares
IPXXU=Inflection Point Acquisition Corp. II - Unit
IQ=iQIYI Inc
IRAA=Iris Acquisition Corp
IRAAU=Iris Acquisition Corp
IRAAW=Iris Acquisition Corp
IRBT=iRobot Corp
IRDM=Iridium Communications Inc
IREN=Iris Energy Limited
IRIX=IRIDEX Corp
IRMD=iRadimed Corp
IROH=Iron Horse Acquisitions Corp. Common Stock
IROHR=Iron Horse Acquisitions Corp. Right
IROHU=Iron Horse Acquisitions Corp.
IROHW=Iron Horse Acquisitions Corp. Warrant
IRON=Disc Medicine, Inc.
IROQ=IF Bancorp Inc
IRTC=iRhythm Technologies Inc
IRWD=Ironwood Pharmaceuticals Inc
ISIG=Insignia Systems, Inc.
ISPC=iSpecimen Inc.
ISPO=Inspirato Inc
ISPOW=Inspirato Incorporated
ISPR=Ispire Technology Inc. - Common Stock
ISRG=Intuitive Surgical Inc
ISRL=Isramco Inc
ISRLU=ISRAEL ACQUISITIONS CORP UNIT 1 CL A SHS & 1 WT EXP
ISSC=Innovative Solutions & Support Inc
ISTR=Investar Holding Corp
ISUN=iSun, Inc.
ITCI=Intra-Cellular Therapies Inc
ITI=Iteris Inc
ITIC=Investors Title Co
ITOS=iTeos Therapeutics, Inc.
ITRI=Itron Inc
ITRM=Iterum Therapeutics plc
ITRN=Ituran Location and Control Ltd
IVA=Inventiva S.A.
IVAC=Intevac Inc
IVCA=Investcorp India Acquisition Corp
IVCAU=Investcorp India Acquisition Corp
IVCAW=Investcorp India Acquisition Corp
IVCB=Investcorp Europe Acquisition Corp I
IVCBU=Investcorp Europe Acquisition Corp I Unit
IVCBW=Investcorp Europe Acquisition Corp I
IVCP=Swiftmerge Acquisition Corp.
IVCPU=Swiftmerge Acquisition Corp. Unit
IVCPW=Swiftmerge Acquisition Corp.
IVDA=Iveda Solutions, Inc.
IVDAW=Iveda Solutions, Inc.
IVP=Inspire Veterinary Partners, Inc. - Class A Common Stock
IVVD=Invivyd Inc
IXAQ=IX Acquisition Corp.
IXAQU=IX Acquisition Corp.
IXAQW=IX Acquisition Corp.
IXHL=Incannex Healthcare Limited
IZEA=IZEA Worldwide Inc
IZM=ICZOOM Group Inc. - Class A Ordinary Shares
JACK=Jack in the Box Inc
JAGX=Jaguar Health Inc
JAKK=JAKKS Pacific Inc
JAMF=Jamf Holding Corp
JAN=JanOne Inc
JANX=Janux Therapeutics, Inc.
JAZZ=Jazz Pharmaceuticals PLC
JBHT=JB Hunt Transport Services Inc
JBLU=JetBlue Airways Corp
JBSS=John B Sanfilippo & Son Inc
JCIC=Jack Creek Investment Corp.
JCOM=j2 Global Inc
JCSE=JE Cleantech Holdings Limited
JCTCF=Jewett-Cameron Trading Co Ltd
JD=JD.com Inc
JEWL=Adamas One Corp.
JFBR=Jeffs Brands Ltd
JFBRW=Jeffs' Brands Ltd
JFIN=Jiayin Group Inc
JFU=9F Inc
JG=Aurora Mobile Ltd
JJSF=J&J Snack Foods Corp
JKHY=Jack Henry & Associates Inc
JL=J-Long Group Limited Ordinary Shares
JMSB=John Marshall Bancorp, Inc.
JNVR=Janover Inc. - Common Stock
JOAN=JOANN Inc.
JOUT=Johnson Outdoors Inc
JRSH=Jerash Holdings US Inc
JRVR=James River Group Holdings Ltd
JSM=Navient Corp
JSPR=Jasper Therapeutics, Inc.
JSPRW=Jasper Therapeutics, Inc.
JTAI=Jetai Inc
JUNE=Junee Limited Ordinary Shares
JUPW=Jupiter Wellness, Inc.
JVA=Coffee Holding Co Inc
JVSA=JV SPAC Acquisition Corp. Class A Ordinary Share
JVSAR=JV SPAC Acquisition Corp. Right
JVSAU=JVSPAC Acquisition Corp. Unit
JWEL=Jowell Global Ltd.
JXJT=JX Luxventure Limited
JYD=Jayud Global Logistics Limited - Class A Ordinary Shares
JYNT=Joint Corp-The
JZ=Jianzhi Education Technology Group Co Ltd
JZXN=Jiuzi Holdings, Inc.
KA=Kineta, Inc.
KACL=Kairous Acquisition Corp. Limited
KACLR=Kairous Acquisition Corp. Limited
KACLU=Kairous Acquisition Corp. Limited Unit
KACLW=Kairous Acquisition Corp. Limited
KALA=Kala Pharmaceuticals Inc
KALU=Kaiser Aluminum Corp
KALV=KalVista Pharmaceuticals Inc
KARO=Karooooo Ltd.
KAVL=Kaival Brands Innovations Group, Inc.
KBNT=Kubient, Inc.
KBNTW=Kubient, Inc.
KC=Kingsoft Cloud Holdings Ltd
KDP=Keurig Dr Pepper Inc
KE=Kimball Electronics Inc
KELYA=Kelly Services Inc
KELYB=Kelly Services Inc
KEQU=Kewaunee Scientific Corp
KERN=Akerna Corp
KFFB=Kentucky First Federal Bancorp
KFRC=Kforce Inc
KGEI=Kolibri Global Energy Inc. - Common stock
KHC=Kraft Heinz Co-The
KIDS=OrthoPediatrics Corp
KINS=Kingstone Cos Inc
KIRK=Kirkland's Inc
KITT=Nauticus Robotics, Inc.
KITTW=Nauticus Robotics, Inc.
KLAC=KLA Corp
KLDO=Kaleido Biosciences Inc
KLIC=Kulicke & Soffa Industries Inc
KLTR=Kaltura, Inc.
KLXE=KLX Energy Services Holdings Inc
KMDA=Kamada Ltd
KNDI=Kandi Technologies Group Inc
KNSA=Kiniksa Pharmaceuticals Ltd
KNTE=Kinnate Biopharma Inc.
KOD=Kodiak Sciences Inc
KOPN=Kopin Corp
KOSS=Koss Corp
KPLT=Katapult Holdings, Inc.
KPLTW=Katapult Holdings, Inc.
KPRX=Kiora Pharmaceuticals, Inc.
KPTI=Karyopharm Therapeutics Inc
KRKR=36Kr Holdings Inc
KRMD=Repro-Med Systems Inc
KRNL=Kernel Group Holdings, Inc.
KRNLU=Kernel Group Holdings, Inc.
KRNLW=Kernel Group Holdings, Inc.
KRNT=Kornit Digital Ltd
KRNY=Kearny Financial Corp-MD
KRON=Kronos Bio Inc
KROS=Keros Therapeutics Inc
KRRO=Korro Bio, Inc.
KRT=Karat Packaging Inc.
KRUS=Kura Sushi USA Inc
KRYS=Krystal Biotech Inc
KSCP=Knightscope, Inc.
KSICW=Kadem Sustainable Impact Corpor
KSPI=Joint Stock Company Kaspi.kz American Depository Shares
KSPN=Kaspien Holdings Inc.
KTCC=Key Tronic Corp
KTOS=Kratos Defense & Security Solutions Inc
KTRA=Kintara Therapeutics, Inc.
KTTA=Pasithea Therapeutics Corp.
KTTAW=Pasithea Therapeutics Corp.
KURA=Kura Oncology Inc
KVAC=Keen Vision Acquisition Corporation - Ordinary Shares
KVHI=KVH Industries Inc
KWE=KWESST Micro Systems Inc.
KWESW=KWESST Micro Systems Inc.
KXIN=Kaixin Auto Holdings
KYCH=Keyarch Acquisition Corporation
KYCHR=Keyarch Acquisition Corporation
KYCHU=Keyarch Acquisition Corp
KYCHW=Keyarch Acquisition Corporation
KYMR=Kymera Therapeutics, Inc.
KYTX=Kyverna Therapeutics, Inc. Common Stock
KZIA=Kazia Therapeutics Ltd
KZR=Kezar Life Sciences Inc
LAAA=Lakeshore Acquisition I Corp.
LAB=Standard BioTools Inc.
LABP=Landos Biopharma, Inc.
LAES=SEALSQ Corp - Ordinary Shares
LAKE=Lakeland Industries Inc
LAMR=Lamar Advertising Co
LANC=Lancaster Colony Corp
LAND=Gladstone Land Corp
LANDM=Gladstone Land Corporation
LANDO=Gladstone Land Corporation
LANDP=Gladstone Land Corp
LARK=Landmark Bancorp Inc-Manhattan KS
LASE=Laser Photonics Corp
LASR=nLight Inc
LATG=LatAmGrowth SPAC
LATGU=LatAmGrowth SPAC
LAUR=Laureate Education Inc
LAWS=Lawson Products Inc-DE
LAX=8i Acquisition 2 Corp. Ordinary Shares
LAZR=Luminar Technologies Inc
LAZY=Lazydays Holdings, Inc.
LBAI=Lakeland Bancorp Inc
LBBB=Lakeshore Acquisition II Corp.
LBBBR=Lakeshore Acquisition II Corp.
LBBBU=Lakeshore Acquisition II Corp
LBBBW=Lakeshore Acquisition II Corp.
LBPH=Longboard Pharmaceuticals, Inc.
LBPSW=4D pharma plc
LBRDA=Liberty Broadband Corp
LBRDK=Liberty Broadband Corp
LBRDP=Liberty Broadband Corporation
LBTYA=Liberty Global PLC
LBTYB=Liberty Global PLC
LBTYK=Liberty Global PLC
LCAA=L Catterton Asia Acquisition Corp
LCAAU=L Catterton Asia Acquisition Corp
LCAHU=Landcadia Holdings II Inc
LCAHW=Landcadia Holdings IV, Inc.
LCFY=Locafy Limited
LCFYW=Locafy Limited
LCID=Lucid Group, Inc.
LCNB=LCNB Corp
LCUT=Lifetime Brands Inc
LDHAW=LDH Growth Corp I
LDTC=LeddarTech Holdings Inc.
LDTCW=LeddarTech Holdings Inc.
LDWY=Lendway Inc
LE=Lands' End Inc
LECO=Lincoln Electric Holdings Inc
LEDS=SemiLEDs Corp-Taiwan
LEE=Lee Enterprises Inc
LEGAW=Lead Edge Growth Opportunities,
LEGH=Legacy Housing Corp
LEGN=Legend Biotech Corp
LENZ=LENZ Therapeutics, Inc.
LESL=Leslie''s Inc
LEXX=Lexaria Bioscience Corp.
LEXXW=Lexaria Bioscience Corp.
LFACW=LF Capital Acquisition Corp. II
LFCR=Lifecore Biomedical, Inc.
LFLY=Leafly Holdings, Inc.
LFLYW=Leafly Holdings, Inc.
LFMD=LifeMD, Inc.
LFMDP=LifeMD, Inc.
LFST=LifeStance Health Group, Inc.
LFUS=Littelfuse Inc
LFVN=Lifevantage Corp
LFWD=ReWalk Robotics Ltd.
LGCB=Linkage Global Inc
LGCL=Lucas GC Limited
LGCY=2
LGHL=Lion Group Holding Ltd.
LGHLW=Lion Financial Group Limited
LGIH=LGI Homes Inc
LGMK=LogicMark, Inc.
LGND=Ligand Pharmaceuticals Inc
LGO=Largo Resources Ltd.
LGST=Semper Paratus Acquisition Corporation
LGVC=LAMF Global Ventures Corp. I
LGVCU=LAMF Global Ventures Corp. I
LGVCW=LAMF Global Ventures Corp. I
LGVN=Longeveron Inc.
LI=Li Auto Inc
LIACF=American Lithium Corp.
LIAN=LianBio
LIBY=Liberty Resources Acquisition Corp.
LIBYU=Liberty Resources Acquisition Corp.
LIBYW=Liberty Resources Acquisition Corp.
LICN=Lichen China Limited
LIDR=AEye, Inc.
LIDRW=AEye, Inc.
LIFE=aTyr Pharma Inc
LIFW=MSP RECOVERY INC
LIFWW=MSP Recovery, Inc.
LIFWZ=MSP Recovery, Inc.
LILA=Liberty Latin America Ltd
LILAK=Liberty Latin America Ltd
LILM=Lilium N.V.
LILMW=Lilium N.V.
LIN=Linde plc
LINC=Lincoln Educational Services Corp
LIND=Lindblad Expeditions Holdings Inc
LINK=Interlink Electronics, Inc.
LIPO=Lipella Pharmaceuticals Inc.
LIQT=LiqTech International Inc
LITE=Lumentum Holdings Inc
LITM=Snow Lake Resources Ltd.
LIVE=Live Ventures Inc
LIVN=LivaNova PLC
LIXT=Lixte Biotechnology Holdings, Inc.
LIXTW=Lixte Biotechnology Holdings, Inc.
LJAQ=LightJump Acquisition Corporation
LKCO=Luokung Technology Corp
LKFN=Lakeland Financial Corp
LKQ=LKQ Corp
LLNW=Limelight Networks Inc
LLYVA=Liberty Media Corporation - Series A Liberty Live Common Stock
LLYVK=Liberty Media Corporation - Series C Liberty Live Common Stock
LMAOU=LMF Acquisition Opportunities Inc.
LMAT=LeMaitre Vascular Inc
LMB=Limbach Holdings Inc
LMDX=LumiraDx Limited
LMDXW=LumiraDx Limited
LMFA=LM Funding America Inc
LMNR=Limoneira Co
LMPX=LMP Automotive Holdings Inc
LNDC=Landec Corp
LNKB=LINKBANCORP Inc
LNKS=Linkers Industries Limited Class A Ordinary Shares
LNSR=LENSAR, Inc.
LNT=Alliant Energy Corp
LNTH=Lantheus Holdings Inc
LNW=Light & Wonder, Inc.
LNZA=LanzaTech Global, Inc.
LOAN=Manhattan Bridge Capital Inc
LOBO=LOBO EV TECHNOLOGIES LTD.
LOCO=El Pollo Loco Holdings Inc
LOGI=Logitech International SA
LOOP=Loop Industries Inc
LOPE=Grand Canyon Education Inc
LOT=L Catterton Asia Acquisition Corp
LOTWW=Lotus Technology Inc. Warrants
LOV=Spark Networks SE
LOVE=Lovesac Co-The
LPCN=Lipocine Inc
LPLA=ETFS 2X Daily Long Platinum
LPRO=Open Lending Corp
LPSN=LivePerson Inc
LPTH=LightPath Technologies Inc
LPTX=Leap Therapeutics Inc
LQDA=iShares USD Corp Bond UCITS ETF
LQDT=Liquidity Services Inc
LQR=LQR House Inc. - Common Stock
LRCX=Lam Research Corp
LRFC=Logan Ridge Finance Corporation
LRHC=La Rosa Holdings Corp. - Common Stock
LRMR=Larimar Therapeutics, Inc.
LSAK=Lesaka Technologies, Inc.
LSBK=Lake Shore Bancorp Inc
LSCC=Lattice Semiconductor Corp
LSDI=Lucy Scientific Discovery Inc.
LSEA=Landsea Homes Corporation
LSEAW=Landsea Homes Corporation
LSTA=Lisata Therapeutics Inc
LSTR=Landstar System Inc
LSXMA=Liberty Media Corp-Liberty SiriusXM
LSXMB=Liberty Media Corp-Liberty SiriusXM
LSXMK=Liberty Media Corp-Liberty SiriusXM
LTBR=Lightbridge Corp
LTCH=Latch, Inc.
LTRN=Lantern Pharma Inc
LTRPA=Liberty TripAdvisor Holdings Inc
LTRPB=Liberty TripAdvisor Holdings Inc
LTRX=Lantronix Inc
LTRY=Lottery.com Inc.
LTRYW=Lottery.com Inc.
LUCD=Lucid Diagnostics Inc.
LUCY=Innovative Eyewear, Inc.
LULU=Lululemon Athletica Inc
LUMO=Lumos Pharma Inc
LUNA=Luna Innovations Inc
LUNG=Pulmonx Corp
LUNR=Intuitive Machines, Inc. - Class A Common Stock
LUXH=LuxUrban Hotels Inc.
LUXHP=LuxUrban Hotels Inc.
LVLU=Lulu's Fashion Lounge Holdings, Inc.
LVO=LiveOne, Inc.
LVRAW=Levere Holdings Corp.
LVRO=Lavoro Limited - Class A Ordinary Shares
LVTX=Lava Therapeutics B.V.
LWAY=Lifeway Foods Inc
LWLG=Lightwave Logic, Inc.
LX=LexinFintech Holdings Ltd
LXEH=Lixiang Education Holding Co Ltd
LXEO=Lexeo Therapeutics, Inc.
LXRX=Lexicon Pharmaceuticals Inc
LYEL=Lyell Immunopharma, Inc.
LYFT=Lyft Inc
LYL=Dragon Victory International Ltd
LYRA=Lyra Therapeutics Inc
LYT=Lytus Technologies Holdings PTV. Ltd.
LYTS=LSI Industries Inc
LZ=LegalZoom.com, Inc.
MAAQ=Mana Capital Acquisition Corp.
MACA=Moringa Acquisition Corp
MACAU=Moringa Acquisition Corp
MACAW=Moringa Acquisition Corp
MACK=Merrimack Pharmaceuticals Inc
MAMA=Mama%u2019s Creations Inc
MAMO=Massimo Group
MANH=Manhattan Associates Inc
MAPS=WM Technology, Inc.
MAPSW=WM Technology, Inc.
MAQC=Maquia Capital Acquisition Corporation
MAQCU=Maquia Capital Acquisition Corporation
MAQCW=Maquia Capital Acquisition Corporation
MAR=Marriott International Inc-MD
MARA=Marathon Patent Group Inc
MARPS=Marine Petroleum Trust
MARX=Mars Acquisition Corp. - Ordinary Shares
MARXU=Mars Acquisition Corp.
MASI=Masimo Corp
MASS=908 Devices Inc.
MAT=Mattel Inc
MATH=Metalpha Technology Holding Limited
MATW=Lyxor MSCI World Materials TR UCITS ETF
MAXN=Maxeon Solar Technologies Ltd
MAYS=JW Mays Inc
MBCN=Middlefield Banc Corp
MBIN=Merchants Bancorp-IN
MBINM=Merchants Bancorp - Depositary Shares, Each Representing a 1/40th Interest in a Share of 8.25% Fixed-Rate Reset Series D Non-Cumulative Perpetual Preferred Stoc
MBINN=Merchants Bancorp
MBINO=Merchants Bancorp-IN
MBINP=Merchants Bancorp-IN
MBIO=Mustang Bio Inc
MBLY=Mobileye Global Inc
MBNKP=Medallion Bank-Salt Lake City UT
MBOT=Microbot Medical Inc
MBRX=Moleculin Biotech Inc
MBTC=Nocturne Acquisition Corporation
MBTCR=Nocturne Acquisition Corporation
MBTCU=Nocturne Acquisition Corporation
MBUU=Malibu Boats Inc
MBWM=Mercantile Bank Corp
MCAA=Mountain & Co. I Acquisition Corp.
MCAAU=Mountain & Co. I Acquisition Corp. Unit
MCAAW=Mountain & Co. I Acquisition Corp.
MCAC=Mountain Crest Acquisition Corp
MCACR=Monterey Capital Acquisition Corporation
MCACU=Monterey Capital Acquisition Co
MCAF=Mountain Crest Acquisition Corp. IV
MCAFR=Mountain Crest Acquisition Corp. IV
MCAFU=Mountain Crest Acquisition Corp. IV
MCAG=Mountain Crest Acquisition Corp. V
MCAGR=Mountain Crest Acquisition Corp. V
MCAGU=Mountain Crest Acquisition Corp. V
MCBC=Macatawa Bank Corp
MCBS=Metrocity Bankshares Inc
MCFT=MasterCraft Boat Holdings Inc
MCHP=Microchip Technology Inc
MCHS=Matthews China Discovery Active ETF
MCHX=Marchex Inc
MCOM=Micromobilitycom Inc
MCRB=Seres Therapeutics Inc
MCRI=Monarch Casino & Resort Inc
MCVT=Mill City Ventures III, Ltd.
MDAI=Spectral Ai Inc
MDB=MongoDB Inc
MDBH=MDB Capital Holdings, LLC - Class A common 
MDGL=Madrigal Pharmaceuticals Inc
MDGS=Medigus Ltd
MDIA=Mediaco Holding Inc
MDJH=MDJM Ltd
MDLZ=Mondelez International Inc
MDNA=Medicenna Therapeutics Corp.
MDNAF=Medicenna Therapeutics Corp.
MDRR=Medalist Diversified REIT Inc
MDRRP=Medalist Diversified REIT Inc
MDRX=Allscripts Healthcare Solutions Inc
MDWD=MediWound Ltd
MDXG=MiMedx Group, Inc.
MDXH=MDxHealth SA
ME=23andMe Holding Co.
MEDP=Medpace Holdings Inc
MEDS=Trxade Group Inc
MEDX=Horizon Kinetics Medical ETF
MEGL=Magic Empire Global Limited
MEIP=MEI Pharma Inc
MELI=MercadoLibre Inc
MEOH=Methanex Corp
MERC=Mercer International Inc
MESA=Mesa Air Group Inc
MESO=Mesoblast Ltd
META=Meta Platforms, Inc.
METC=Ramaco Resources Inc
METCB=Ramaco Resources, Inc. - Class B Common Stock
METCL=Ramaco Resources, Inc. - 9.00% 
METX=BTC Digital Ltd.
MF=Missfresh Limited
MFH=JMU Ltd
MFI=mF International Limited Ordinary Shares
MFIC=MidCap Financial Investment Co
MFICL=MidCap Financial Investment Corporation
MFIN=Medallion Financial Corp
MGEE=MGE Energy Inc
MGIC=Magic Software Enterprises Ltd
MGIH=Millennium Group International Holdings Limited - Ordinary Shares
MGNI=Magnite, Inc.
MGNX=MacroGenics Inc
MGOL=MGO Global Inc. Common Stock
MGPI=MGP Ingredients Inc
MGRC=McGrath RentCorp
MGRM=Monogram Orthopaedics Inc. - Common Stock
MGRX=Mangoceuticals, Inc. - Common Stock
MGTA=Magenta Therapeutics, Inc.
MGTX=MeiraGTx Holdings plc
MGX=Metagenomi, Inc. Common Stock
MGYR=Magyar Bancorp Inc
MHLD=Maiden Holdings Ltd
MHUA=Meihua International Medical Technologies Co., Ltd.
MICS=The Singing Machine Company, Inc.
MIDD=Middleby Corp-The
MIGI=Mawson Infrastructure Group, Inc.
MIND=Mitcham Industries Inc
MINDP=Mitcham Industries Inc
MINM=Zoom Telephonics, Inc.
MIRA=MIRA Pharmaceuticals, Inc. - Common Stock
MIRM=Mirum Pharmaceuticals Inc
MIST=Milestone Pharmaceuticals Inc
MITA=Coliseum Acquisition Corp.
MITAU=Coliseum Acquisition Corp.
MITC=MeaTech 3D Ltd.
MITK=Mitek Systems Inc
MKSI=MKS Instruments Inc
MKTW=MarketWise, Inc.
MKTX=MarketAxess Holdings Inc
MLAB=Mesa Laboratories Inc
MLCO=Melco Resorts & Entertainment Ltd
MLEC=MOOLEC SCIENCE SA
MLECW=Moolec Science SA Warrant
MLGO=MicroAlgo, Inc.
MLKN=MillerKnoll, Inc.
MLTX=MoonLake Immunotherapeutics
MLYS=Mineralys Therapeutics, Inc.
MMAT=Meta Materials Inc.
MMLP=Martin Midstream Partners LP
MMSI=Merit Medical Systems Inc
MMV=Model Performance Acquisition Corp.
MMVWW=MultiMetaVerse Holdings Limited
MMYT=MakeMyTrip Ltd
MNDO=Mind CTI Ltd
MNDR=Mobile-health Network Solutions
MNDY=monday.com Ltd.
MNKD=MannKind Corp
MNMD=Mind Medicine 
MNOV=MediciNova Inc
MNPR=Monopar Therapeutics Inc
MNRO=Monro Inc
MNSB=MainStreet Bancshares Inc
MNSBP=MainStreet Bancshares, Inc.
MNST=Monster Beverage Corp
MNTK=Montauk Renewables, Inc.
MNTL=Tema Neuroscience and Mental Health ETF
MNTS=Momentus Inc.
MNTSW=Momentus Inc.
MNTX=Manitex International Inc
MNY=Moneyhero Ltd.
MOB=Mobilicom Ltd-Australia
MOBBW=Mobilicom Limited
MOBQ=Mobiquity Technologies, Inc.
MOBQW=Mobiquity Technologies, Inc.
MOBX=Mobix Labs, Inc.
MOBXW=Mobix Labs, Inc.
MODD=Modular Medical, Inc.
MODV=ModivCare Inc.
MOFG=MidWestOne Financial Group Inc
MOGO=Mogo Inc
MOLN=Molecular Partners AG
MOMO=Momo Inc
MOND=Mondee Holdings, Inc.
MOR=MorphoSys AG
MORF=Morphic Holding Inc
MORN=Morningstar Inc
MOVE=Movano Inc.
MPAA=Motorcar Parts of America Inc
MPAC=Model Performance Acquisition Corp.
MPB=Mid Penn Bancorp Inc
MPRA=Mercato Partners Acquisition Corporation
MPWR=Monolithic Power Systems Inc
MQ=Marqeta, Inc.
MRAI=Marpai, Inc.
MRAM=Everspin Technologies Inc
MRBK=Meridian Corp
MRCC=Monroe Capital Corp
MRCY=Mercury Systems Inc
MREO=Mereo Biopharma Group PLC
MRIN=Marin Software Inc
MRKR=Marker Therapeutics Inc
MRM=MEDIROM Healthcare Technologies Inc.
MRNA=Moderna Inc
MRNO=Murano Global Investments PLC
MRNOW=Murano Global Investments Plc
MRNS=Marinus Pharmaceuticals Inc
MRSN=Mersana Therapeutics Inc
MRTN=Marten Transport Ltd
MRUS=Merus NV
MRVI=Maravai LifeSciences Holdings Inc
MRVL=Marvell Technology Group Ltd
MSAI=Infrared Cameras Holdings, Inc.
MSAIW=Infrared Cameras Holdings, Inc.
MSBI=Midland States Bancorp Inc
MSBIP=Midland States Bancorp, Inc. - Depositary Shares Each Representing a 1/40th Interest in a Share of 7.750% Fixed-Rate Reset Non-Cumulative Perpetual Preferred St
MSDA=MSD Acquisition Corp.
MSDAW=MSD Acquisition Corp.
MSEX=Middlesex Water Co
MSFT=Microsoft Corp
MSGM=Motorsport Games Inc.
MSPR=MSP Recovery, Inc.
MSS=Maison Solutions Inc. - Class A Common Stock
MSSA=Metal Sky Star Acquisition Corporation
MSSAR=Metal Sky Star Acquisition Corporation
MSSAU=Metal Sky Star Acquisition Corp
MSSAW=Metal Sky Star Acquisition Corporation
MSTR=MicroStrategy Inc
MSVB=Mid-Southern Bancorp Inc
MTAC=MedTech Acquisition Corporation
MTBC=MTBC Inc
MTBCP=MTBC Inc
MTC=MMTEC Inc
MTCH=Match Group Inc
MTEK=Maris-Tech Ltd.
MTEKW=Maris-Tech Ltd.
MTEM=Molecular Templates Inc
MTEN=Mingteng International Corporation Inc. Ordinary Shares
MTEX=Mannatech Inc
MTLS=Materialise NV
MTP=Midatech Pharma PLC
MTRX=Matrix Service Co
MTSI=MACOM Technology Solutions Holdings Inc
MTTR=Matterport, Inc.
MU=Micron Technology Inc
MULN=Mullen Automotive, Inc.
MURA=Mural Oncology plc
MURF=Murphy Canyon Acquisition Corp.
MVBF=MVB Financial Corp
MVIS=MicroVision Inc
MVST=Microvast Holdings, Inc.
MVSTW=Microvast Holdings, Inc.
MXCT=MaxCyte, Inc.
MXL=MaxLinear Inc
MYFW=First Western Financial Inc
MYGN=Myriad Genetics Inc
MYMD=MyMD Pharmaceuticals, Inc.
MYNA=Mynaric AG - American Depositor
MYNZ=Mainz Biomed B.V.
MYPS=PLAYSTUDIOS, Inc.
MYPSW=PLAYSTUDIOS Inc
MYRG=MYR Group Inc
MYSZ=My Size Inc
NA=Nano Labs Ltd
NAAS=NaaS Technology Inc
NAII=Natural Alternatives International Inc
NAMS=NewAmsterdam Pharma Company N.V.
NAMSW=NewAmsterdam Pharma Company N.V.
NAOV=NanoVibronix Inc
NARI=Inari Medical Inc
NATH=Nathan's Famous Inc
NATR=Nature's Sunshine Products Inc
NAUT=Nautilus Biotechnology, Inc.
NAVI=Navient Corp
NB=NioCorp Developments Ltd. - Common Stock
NBBK=NB Bancorp, Inc.
NBIX=Neurocrine Biosciences Inc
NBN=Northeast Bank
NBSE=NeuBase Therapeutics Inc
NBST=Newbury Street Acquisition Corporation
NBTB=NBT Bancorp Inc
NBTX=Nanobiotix S.A.
NCMI=National CineMedia Inc
NCNA=NuCana PLC
NCNC=Noco-noco Inc
NCNO=nCino Inc
NCPB=Nuveen Core Plus Bond ETF
NCPL=Netcapital Inc.
NCPLW=Netcapital Inc.
NCRA=Nocera Inc.
NCSM=NCS Multistage Holdings Inc
NCTY=The9 Ltd
NDAQ=Nasdaq Inc
NDLS=Noodles & Co
NDRA=ENDRA Life Sciences Inc
NDSN=Nordson Corp
NECB=Northeast Community Bancorp, Inc.
NEGG=Newegg Commerce, Inc.
NEO=NeoGenomics Inc
NEOG=Neogen Corp
NEOGV=Neogen Corporation
NEON=Neonode Inc
NEOV=NeoVolta, Inc.
NEOVW=NeoVolta Inc.
NEPH=Nephros Inc
NEPT=Neptune Wellness Solutions Inc
NERV=Minerva Neurosciences Inc
NESR=National Energy Services Reunited Corp
NETD=Nabors Energy Transition Corp. II - Class A Ordinary Shares
NETE=Net Element Inc
NEWT=Newtek Business Services Corp
NEWTL=Newtek Business Services Corp
NEWTZ=Newtek Business Services Corp
NEWZ=StockSnips AI-Powered Sentiment US All Cap ETF
NEXI=NexImmune, Inc.
NEXN=Tremor International Ltd. - American Depository Shares
NEXT=NextDecade Corp
NFBK=Northfield Bancorp Inc
NFE=New Fortress Energy LLC
NFLX=Netflix Inc
NGM=NGM Biopharmaceuticals Inc
NGMS=NEOGAMES SA
NGNE=Neurogene Inc.
NH=NantHealth, Inc.
NHTC=Natural Health Trends Corp
NICE=Nice Ltd
NICK=ETFS Nickel
NIR=Near Intelligence Inc
NISN=Nisun International Enterprise Development Group Co., Ltd
NITO=N2OFF, Inc.
NIU=Niu Technologies
NIVF=NewGenIvf Group Limited Class A ordinary shares
NIVFW=NewGenIvf Group Limited Warrants
NKGN=
NKLA=Nikola Corp
NKSH=National Bankshares Inc
NKTR=Nektar Therapeutics
NKTX=Nkarta Inc
NLIT=Northern Lights Acquisition Corp.
NLSP=NLS Pharmaceutics AG
NLSPW=NLS Pharmaceutics AG
NMFC=New Mountain Finance Corp
NMFCZ=New Mountain Finance Corporation
NMHI=Nature's Miracle Holding Inc.
NMHIW=Nature's Miracle Holding Inc.
NMIH=NMI Holdings Inc
NMRA=Neumora Therapeutics, Inc. - Common Stock
NMRD=Nemaura Medical Inc
NMRK=Newmark Group Inc
NMTC=NeuroOne Medical Technologies Corporation
NN=NextNav Inc.
NNAG=99 Acquisition Group Inc. - Class A Common Stock
NNAVW=NextNav Inc.
NNBR=NN Inc
NNDM=Nano Dimension Ltd
NNOX=Nano-X Imaging Ltd
NODK=NI Holdings Inc
NOGN=Nogin Inc
NOGNW=Nogin, Inc.
NOTV=Inotiv, Inc.
NOVT=Novanta Inc
NOVV=Nova Vision Acquisition Corporation
NOVVR=Nova Vision Acquisition Corporation
NOVVU=Nova Vision Acquisition Corporation
NOVVW=Nova Vision Acquisition Corporation
NPAB=New Providence Acquisition Corp. II
NPABU=New Providence Acquisition Corp. II Unit
NPABW=New Providence Acquisition Corp. II
NPCE=NeuroPace, Inc.
NPFI=Nuveen Preferred and Income ETF
NRAC=Noble Rock Acquisition Corporation
NRACU=Noble Rock Acquisition Corporation
NRACW=Noble Rock Acquisition Corporation
NRBO=NeuroBo Pharmaceuticals Inc
NRC=National Research Corp
NRDS=NerdWallet, Inc.
NRIM=Northrim BanCorp Inc
NRIX=Nurix Therapeutics, Inc.
NRSN=NeuroSense Therapeutics Ltd.
NRSNW=NeuroSense Therapeutics Ltd.
NRXP=NRx Pharmaceuticals, Inc.
NRXPW=NRx Pharmaceuticals, Inc.
NSCR=Nuveen Sustainable Core ETF
NSIT=Insight Enterprises Inc
NSPR=InspireMD Inc
NSSC=Napco Security Technologies Inc
NSTG=NanoString Technologies Inc
NSTS=NSTS Bancorp, Inc.
NSYS=Nortech Systems Inc
NTAP=NetApp Inc
NTBL=Notable Labs Ltd.
NTCT=NetScout Systems Inc
NTES=NetEase Inc
NTGR=NETGEAR Inc
NTHI=NEONC TECHNOLOGIES HOLDINGS, INC.
NTIC=Northern Technologies International Corp
NTLA=Intellia Therapeutics Inc
NTNX=Nutanix Inc
NTRA=Natera Inc
NTRB=Nutriband Inc.
NTRBW=Nutriband Inc.
NTRP=Neurotrope Inc
NTRS=Northern Trust Corp
NTRSO=Northern Trust Corp
NTWK=NetSol Technologies Inc
NUBIW=Nubia Brand International Corp.
NUKK=Nukkleus Inc.
NUKKW=Nukkleus Inc.
NURO=NeuroMetrix Inc
NUSB=Nushares Etf Trust - Ultra Short Income Etf
NUTX=Nutex Health, Inc.
NUVL=Nuvalent, Inc.
NUWE=Nuwellis, Inc.
NUZE=NuZee, Inc.
NVAC=NorthView Acquisition Corporation
NVACR=NorthView Acquisition Corporation
NVACW=NorthView Acquisition Corporation
NVAX=Novavax Inc
NVCR=Novocure Ltd
NVCT=Nuvectis Pharma, Inc.
NVDA=NVIDIA Corp
NVEC=NVE Corp
NVEE=NV5 Global Inc
NVEI=Nuvei Corporation - Subordinate
NVFY=Nova Lifestyle Inc
NVMI=Nova Measuring Instruments Ltd
NVNI=Nvni Group Limited - Ordinary Shares
NVNO=enVVeno Medical Corporation
NVNOW=enVVeno Medical Corporation
NVOS=Novo Integrated Sciences, Inc.
NVTS=Navitas Semiconductor Corporation
NVVE=Nuvve Holding Corp.
NVVEW=Nuvve Holding Corp.
NVX=NOVONIX Limited - American Depository Shares
NWBI=Northwest Bancshares Inc
NWE=NorthWestern Corp
NWFL=Norwood Financial Corp
NWL=Newell Brands Inc
NWLI=National Western Life Group Inc
NWPX=Northwest Pipe Co
NWS=News Corp
NWSA=News Corp
NWTN=NWTN Inc.
NWTNW=NWTN Inc.
NXGL=NexGel, Inc Common Stock
NXGLW=NEXGEL, Inc.
NXL=Nexalin Technology Inc
NXLIW=Nexalin Technology, Inc.
NXPI=NXP Semiconductors NV
NXPL=NextPlat Corp
NXPLW=NextPlat Corp
NXST=Nexstar Media Group Inc
NXT=Nextracker Inc.
NXTC=NextCure Inc
NXTT=Next Technology Holding Inc.
NYAX=Nayax Ltd.
NYMT=New York Mortgage Trust Inc
NYMTL=New York Mortgage Trust, Inc.
NYMTM=New York Mortgage Trust Inc
NYMTN=New York Mortgage Trust Inc
NYMTZ=New York Mortgage Trust, Inc. -
NYXH=Nyxoah S.A.
OABI=OmniAb, Inc.
OABIV=OmniAb, Inc.
OABIW=OmniAb, Inc.
OAKU=Oak Woods Acquisition Corporation - Class A Ordinary Shares
OAS=Oasis Petroleum Inc
OB=Outbrain Inc.
OBIO=Health Sciences Acquisitions Corporation 2
OBLG=Oblong Inc
OBT=Orange County Bancorp, Inc.
OCAX=OCA Acquisition Corp.
OCAXU=OCA Acquisition Corp.
OCAXW=OCA Acquisition Corp.
OCC=Optical Cable Corp
OCCI=OFS Credit Co Inc
OCCIN=OFS Credit Company, Inc. - 5.25
OCCIO=OFS Credit Company, Inc.
OCEA=Ocean Biomedical, Inc.
OCFC=OceanFirst Financial Corp
OCFCP=OceanFirst Financial Corp
OCG=Oriental Culture Holding LTD
OCGN=Ocugen Inc
OCS=Oculis Holding AG - Ordinary shares
OCSL=Oaktree Specialty Lending Corp
OCTO=Eightco Holdings Inc
OCUL=Ocular Therapeutix Inc
OCUP=Ocuphire Pharma, Inc.
OCX=Oncocyte Corp
ODD=ODDITY Tech Ltd. - Class A Ordinary Shares
ODFL=Old Dominion Freight Line Inc
ODP=Office Depot Inc
ODVWZ=Osisko Development Corp.
OEPWU=One Equity Partners Open Water I Corp.
OESX=Orion Energy Systems Inc
OFED=Oconee Federal Financial Corp
OFIX=Orthofix Medical Inc
OFLX=Omega Flex Inc
OFS=OFS Capital Corp
OFSSH=OFS Capital Corporation 4.95% Notes due 2028
OFSSI=OFS Capital Corporation - 5.95%
OGI=Organigram Holdings Inc
OHAAW=OPY Acquisition Corp. I
OIG=Orbital Infrastructure Group, Inc.
OKTA=Okta Inc
OKYO=OKYO Pharma Ltd
OLB=The OLB Group, Inc.
OLED=Universal Display Corp
OLK=Olink Holding AB 
OLLI=Ollie's Bargain Outlet Holdings Inc
OLMA=Olema Pharmaceuticals Inc
OLPX=Olaplex Holdings, Inc.
OM=Outset Medical Inc
OMAB=Grupo Aeroportuario del Centro Norte SAB de CV
OMCL=Omnicell Inc
OMER=Omeros Corp
OMEX=Odyssey Marine Exploration Inc
OMGA=Omega Therapeutics, Inc.
OMH=Ohmyhome Limited - Ordinary Shares
OMIC=Singular Genomics Systems, Inc.
OMQS=OMNIQ Corp.
ON=ON Semiconductor Corp
ONB=Old National Bancorp-IN
ONBPO=Old National Bancorp - Depositary Shares, Each Representing a 1/40th Interest in a Share of Series C Preferred Stock
ONBPP=Old National Bancorp - Depositary Shares, Each Representing a 1/40th Interest in a Share of Series A Preferred Stock
ONCO=Onconetix, Inc.
ONCT=Oncternal Therapeutics Inc
ONCY=Oncolytics Biotech Inc
ONDS=Ondas Holdings Inc.
ONEW=OneWater Marine Inc
ONFO=Onfolio Holdings Inc. Common St
ONFOW=Onfolio Holdings, Inc.
ONMD=OneMedNet Corp
ONMDW=OneMedNet Corporation
ONTX=Onconova Therapeutics Inc
ONVO=Organovo Holdings Inc
ONYX=Onyx Acquisition Co. I
ONYXU=Onyx Acquisition Co. I
ONYXW=Onyx Acquisition Co. I
OP=OceanPal Inc.
OPAL=OPAL Fuels Inc.
OPBK=OP Bancorp
OPCH=Option Care Health Inc
OPEN=Opendoor Technologies Inc.
OPGN=OpGen Inc
OPHC=OptimumBank Holdings Inc
OPI=Office Properties Income Trust
OPINL=Office Properties Income Trust
OPK=OPKO Health Inc
OPOF=Old Point Financial Corp
OPRA=Opera Ltd
OPRT=Oportun Financial Corp
OPRX=OptimizeRx Corp
OPT=Opthea Ltd
OPTN=Optinose Inc
OPTX=Syntec Optics Holdings, Inc.
OPTXW=Syntec Optics Holdings, Inc.
OPXS=Optex Systems Holdings, Inc.
ORGN=Origin Materials, Inc.
ORGNW=Origin Materials, Inc.
ORGO=Organogenesis Holdings Inc
ORGS=Orgenesis Inc
ORIC=ORIC Pharmaceuticals Inc
ORLY=O'Reilly Automotive Inc
ORMP=Oramed Pharmaceuticals Inc
ORRF=Orrstown Financial Services Inc
OSA=ProSomnus, Inc.
OSAAW=ProSomnus, Inc.
OSBC=Old Second Bancorp Inc
OSIS=OSI Systems Inc
OSPN=OneSpan Inc
OSS=One Stop Systems Inc
OST=Ostin Technology Group Co., Ltd.
OSTK=Overstock.com Inc
OSUR=OraSure Technologies Inc
OSW=OneSpaWorld Holdings Ltd
OTEC=OceanTech Acquisitions I Corp.
OTECU=OceanTech Acquisitions I Corp.
OTECW=OceanTech Acquisitions I Corp.
OTEX=Open Text Corp
OTLK=Outlook Therapeutics Inc
OTLY=Oatly Group AB
OTMOW=Otonomo Technologies Ltd.
OTRK=Ontrak, Inc.
OTTR=Otter Tail Corp
OVBC=Ohio Valley Banc Corp
OVID=Ovid therapeutics Inc
OVLY=Oak Valley Bancorp
OXAC=Oxbridge Acquisition Corp.
OXBR=Oxbridge Re Holdings Ltd
OXBRW=Oxbridge Re Holdings Limited
OXLCL=Oxford Lane Capital Corp. 6.75% Notes due 2031
OXLCM=Oxford Lane Capital Corp
OXLCN=Oxford Lane Capital Corp. - 7.125% Series 2029 Term Preferred Stock
OXLCO=Oxford Lane Capital Corp
OXLCP=Oxford Lane Capital Corp
OXLCZ=Oxford Lane Capital Corp. - 5.00% Notes due 2027
OXSQG=Oxford Square Capital Corp. 5.50% Notes due 2028
OXSQZ=Oxford Square Capital Corp
OXUS=Oxus Acquisition Corp.
OZK=Bank OZK
OZKAP=Bank OZK - 4.625% Series A Non-
PAA=Plains All American Pipeline LP
PABD=iShares Paris-Aligned Climate MSCI World ex USA ETF
PACB=Pacific Biosciences of California Inc
PACWP=PacWest Bancorp - Depositary Shares Each Representing a 1/40th Interest in a Share of 7.75% Fixed Rate Non-Cumulative Perpetual Preferred Stock, Series A
PAFO=Pacifico Acquisition Corp.
PAGP=Plains GP Holdings LP
PAHC=Phibro Animal Health Corp
PALI=Palisade Bio, Inc.
PALT=Paltalk, Inc.
PANL=Pangaea Logistics Solutions Ltd
PANW=Palo Alto Networks Inc
PAQC=Provident Acquisition Corp.
PARA=Paramount Global
PARAA=Paramount Global
PARAP=Paramount Global - 5.75% Series A Mandatory Convertible Preferred Stock
PASG=Passage Bio Inc
PATK=Patrick Industries Inc
PAVM=PAVmed Inc
PAVMW=PAVmed Inc.
PAVMZ=PAVmed Inc
PAVS=Paranovus Entertainment Technology Ltd. - Class A Ordinary Shares
PAX=Patria Investments Limited
PAYO=Payoneer Global Inc.
PAYOW=Payoneer Global Inc.
PAYS=Paysign Inc
PAYX=Paychex Inc
PBAX=Phoenix Biotech Acquisition Corp.
PBBK=PB Bankshares, Inc.
PBFS=Pioneer Bancorp Inc-NY
PBHC=Pathfinder Bancorp Inc
PBM=Newcourt Acquisition Corp
PBMWW=Psyence Biomedical Ltd. Warrant
PBNC=PB Financial Corporation
PBPB=Potbelly Corp
PBYI=Puma Biotechnology Inc
PCAR=PACCAR Inc
PCB=PCB Bancorp
PCH=PotlatchDeltic Corp
PCRX=Pacira BioSciences Inc
PCSA=Processa Pharmaceuticals, Inc.
PCT=PureCycle Technologies, Inc.
PCTTU=PureCycle Technologies, Inc.
PCTTW=PureCycle Technologies, Inc.
PCTY=Paylocity Holding Corp
PCVX=Vaxcyte, Inc.
PCYG=Park City Group Inc
PCYO=Pure Cycle Corp
PDCO=Patterson Cos Inc
PDD=Pinduoduo Inc
PDEX=Pro-Dex Inc
PDFS=PDF Solutions Inc
PDLB=PDL Community Bancorp
PDSB=PDS Biotechnology Corp
PDYN=Palladyne AI Corp.
PDYNW=Palladyne AI Corp.
PEARW=Pear Therapeutics, Inc.
PEBK=Peoples Bancorp of North Carolina Inc
PEBO=Peoples Bancorp Inc-OH
PECO=Phillips Edison & Company, Inc.
PEGA=Pegasystems Inc
PEGR=Project Energy Reimagined Acquisition Corp.
PEGRU=Project Energy Reimagined Acquisition Corp. Unit
PEGRW=Project Energy Reimagined Acquisition Corp.
PEGY=Pineapple Energy Inc
PENN=Penn National Gaming Inc
PEP=PepsiCo Inc
PEPG=PepGen Inc.
PEPL=PepperLime Health Acquisition Corporation
PEPLU=PepperLime Health Acquisition Corporation
PEPLW=PepperLime Health Acquisition Corporation
PERI=Perion Network Ltd
PESI=Perma-Fix Environmental Services
PET=Wag! Group Co.
PETQ=PetIQ Inc
PETS=PetMed Express Inc
PETWW=Wag! Group Co.
PETZ=TDH Holdings Inc
PEV=Phoenix Motor Inc.
PFBC=Preferred Bank-Los Angeles CA
PFC=Premier Financial Corp.
PFG=Principal Financial Group Inc
PFHC=ProFrac Holding Corp.
PFIE=Profire Energy Inc
PFIS=Peoples Financial Services Corp
PFMT=Performant Financial Corp
PFTA=Portage Fintech Acquisition Corporation
PFTAU=Portage Fintech Acquisition Corporation
PFX=PhenixFIN Corporation
PFXNZ=PhenixFIN Corporation  5.25% Notes due 2028
PGC=Peapack Gladstone Financial Corp
PGEN=Precigen Inc
PGNY=Progyny Inc
PGY=Pagaya Technologies Ltd.
PGYWW=Pagaya Technologies Ltd.
PHAR=Pharming Group N.V.
PHAT=Phathom Pharmaceuticals Inc
PHIO=Phio Pharmaceuticals Corp
PHUN=Phunware Inc
PHUNW=Phunware Inc.
PHVS=Pharvaris B.V.
PI=Impinj Inc
PIII=P3 Health Partners Inc.
PIIIW=P3 Health Partners Inc.
PIK=Kidpik Corp.
PINC=Premier Inc
PIRS=Pieris Pharmaceuticals Inc
PIXY=ShiftPixy Inc
PKBK=Parke Bancorp Inc
PKOH=Park-Ohio Holdings Corp
PLAB=Photronics Inc
PLAO=Patria Latin American Opportunity Acquisition Corp.
PLAOU=Patria Latin American Opportunity Acquisition Corp
PLAOW=Patria Latin American Opportunity Acquisition Corp.
PLAY=Dave & Buster's Entertainment Inc
PLBC=Plumas Bancorp
PLBY=PLBY Group, Inc.
PLCE=Children's Place Inc-The
PLL=Piedmont Lithium Ltd
PLMI=Plum Acquisition Corp. I
PLMIU=Plum Acquisition Corp. I
PLMIW=Plum Acquisition Corp. I
PLMJ=Plum Acquisition Corp. III
PLMJU=Plum Acquisition Corp. III
PLMJW=Plum Acquisition Corp. III
PLMR=Palomar Holdings Inc
PLPC=Preformed Line Products Co
PLRX=Pliant Therapeutics Inc
PLSE=Pulse Biosciences Inc
PLTK=Playtika Holding Corp.
PLTN=PLUTONIAN ACQUISITION CORP
PLTNR=Plutonian Acquisition Corp. Rights
PLTNU=Plutonian Acquisition Corp.
PLTNW=Plutonian Acquisition Corp. Warrant
PLUG=Plug Power Inc
PLUR=Pluri Inc
PLUS=ePlus Inc
PLXS=Plexus Corp
PLYA=Playa Hotels & Resorts NV
PMCB=PharmaCyte Biotech, Inc.
PMD=Psychemedics Corp
PMEC=Primech Holdings Ltd. - Ordinary Shares
PMGM=Priveterra Acquisition Corp.
PMGMU=Priveterra Acquisition Corp.
PMGMW=Priveterra Acquisition Corp.
PMN=ProMIS Neurosciences, Inc.
PMTS=CPI Card Group Inc
PMVP=PMV Pharmaceuticals, Inc.
PNAC=Prime Number Acquisition I Corp.
PNBK=Patriot National Bancorp Inc
PNFP=Pinnacle Financial Partners Inc
PNFPP=Pinnacle Financial Partners, Inc.
PNRG=PrimeEnergy Resources Corp
PNTG=Pennant Group Inc-The
POAI=Predictive Oncology Inc
POCI=Precision Optics Corporation, Inc.
PODC=PodcastOne, Inc. - Common Stock
PODD=Insulet Corp
POET=POET Technologies Inc.
POLA=Polar Power Inc
POOL=Pool Corp
POWI=Power Integrations Inc
POWL=Powell Industries Inc
POWW=AMMO, Inc.
POWWP=AMMO, Inc.
PPBI=Pacific Premier Bancorp Inc
PPBT=Purple Biotech Ltd.
PPC=Pilgrim's Pride Corp
PPHP=PHP Ventures Acquisition Corp. Class A Common Stock
PPHPR=PHP Ventures Acquisition Corp.
PPHPW=PHP Ventures Acquisition Corp.
PPIH=Perma-Pipe International Holdings Inc
PPSI=Pioneer Power Solutions Inc
PPTA=Perpetua Resources Corp.
PPYA=Papaya Growth Opportunity Corp. I
PPYAU=Papaya Growth Opportunity Corp I
PPYAW=Papaya Growth Opportunity Corp. I
PRAA=PRA Group Inc
PRAX=Praxis Precision Medicines Inc
PRCH=Porch Group, Inc.
PRCT=PROCEPT BioRobotics Corporation
PRDO=Perdoceo Education Corp
PRE=Prenetics Global Ltd
PRENW=Prenetics Global Limited
PRFT=Perficient Inc
PRFX=PainReform Ltd.
PRGS=Progress Software Corp
PRLD=Prelude Therapeutics Incorporated
PRLH=Pearl Holdings Acquisition Corp
PRLHU=Pearl Holdings Acquisition Corp Unit
PRLHW=Pearl Holdings Acquisition Corp
PRME=Prime Medicine, Inc.
PROC=Procaps Group, S.A.
PROCW=Procaps Group, S.A.
PROF=Profound Medical Corp
PROG=Progenity Inc
PROK=ProKidney Corp.
PROV=Provident Financial Holdings Inc
PRPH=ProPhase Labs Inc
PRPL=Purple Innovation Inc
PRPO=Precipio Inc
PRQR=ProQR Therapeutics NV
PRSO=Peraso, Inc.
PRSR=Prospector Capital Corp.
PRST=Presto Automation, Inc.
PRSTW=Presto Automation, Inc.
PRTA=Prothena Corp PLC
PRTC=PureTech Health plc
PRTG=Portage Biotech Inc.
PRTH=Priority Technology Holdings Inc
PRTS=US Auto Parts Network Inc
PRVA=Privia Health Group, Inc.
PRZO=ParaZero Technologies Ltd. - Ordinary Shares
PSEC=Prospect Capital Corp
PSHG=Performance Shipping Inc
PSMT=PriceSmart Inc
PSNL=Personalis Inc
PSNY=Polestar Automotive Holding UK PLC
PSNYW=Polestar Automotive Holding UK Limited
PSTI=Pluristem Therapeutics Inc
PSTV=Plus Therapeutics Inc
PSTX=Poseida Therapeutics, Inc.
PT=Pintec Technology Holdings Ltd
PTC=PTC Inc
PTCT=PTC Therapeutics Inc
PTEN=Patterson-UTI Energy Inc
PTGX=Protagonist Therapeutics Inc
PTHRU=Pono Capital Three, Inc. Unit
PTIX=Protagenic Therapeutics, Inc.
PTIXW=Protagenic Therapeutics, Inc.
PTLO=Portillo's Inc.
PTOCW=Pine Technology Acquisition Cor
PTON=Peloton Interactive Inc
PTPI=Petros Pharmaceuticals, Inc.
PTSI=PAM Transportation Services Inc
PTVE=Pactiv Evergreen Inc
PTWO=Pono Capital Two, Inc.
PTWOU=Pono Capital Two Inc
PTWOW=Pono Capital Two, Inc.
PUBM=PubMatic Inc
PUCK=Goal Acquisitions Corp.
PUCKU=Goal Acquisitions Corp.
PUCKW=Goal Acquisitions Corp.
PULM=Pulmatrix Inc
PUYI=Puyi Inc
PVBC=Provident Bancorp Inc
PWFL=Powerfleet Inc
PWM=Prestige Wealth Inc. - Ordinary Shares
PWOD=Penns Woods Bancorp Inc
PWP=Perella Weinberg Partners
PWUP=PowerUp Acquisition Corp.
PWUPU=PowerUp Acquisition Corp
PWUPW=PowerUp Acquisition Corp.
PXLW=Pixelworks Inc
PXMD=PaxMedica, Inc.
PXS=Pyxis Tankers Inc
PXSAP=Pyxis Tankers Inc.
PXSAW=Pyxis Tankers Inc.
PYCR=Paycor HCM, Inc.
PYPD=PolyPid Ltd
PYPL=PayPal Holdings Inc
PYR=PyroGenesis Canada Inc.
PYXS=Pyxis Oncology, Inc.
PZZA=Papa John's International Inc
QCOM=QUALCOMM Inc
QCRH=QCR Holdings Inc
QDEL=Quidel Corp
QDRO=Quadro Acquisition One Corp. - Class A Ordinary Shares
QETA=Quetta Acquisition Corporation
QETAR=Quetta Acquisition Corporation
QFIN=360 Finance Inc
QH=Quhuo Limited
QIPT=Quipt Home Medical Corp.
QIWI=QIWI plc
QLGN=Qualigen Therapeutics, Inc.
QLI=Qilian International Holding Group Limited
QLYS=Qualys Inc
QMCO=Quantum Corp
QMID=WisdomTree U.S. MidCap Quality Growth Fund
QNCX=Quince Therapeutics, Inc.
QNRX=Quoin Pharmaceuticals, Ltd.
QNST=QuinStreet Inc
QOMO=Qomolangma Acquisition Corp.
QOMOR=Qomolangma Acquisition Corp.
QOMOU=Qomolangma Acquisition Corp
QOMOW=Qomolangma Acquisition Corp.
QQQI=NEOS NASDAQ 100 HIGH INCOME ETF
QQQX=Nuveen NASDAQ 100 Dynamic Overwrite Fund
QRHC=Quest Resource Holding Corp
QRTEA=Qurate Retail Inc
QRTEB=Qurate Retail Inc
QRTEP=Qurate Retail, Inc.
QRVO=Qorvo Inc
QSG=QuantaSing Group Ltd
QSI=Quantum-Si incorporated
QSIAW=Quantum-Si incorporated
QSML=WisdomTree U.S. SmallCap Quality Growth Fund
QTEKW=QualTek Services Inc.
QTI=QT Imaging Holdings, Inc.
QTRX=Quanterix Corp
QTTB=Q32 Bio Inc.
QUBT=Quantum Computing Inc.
QUIK=QuickLogic Corp
QURE=uniQure NV
RACY=Relativity Acquisition Corp.
RACYU=Relativity Acquisition Corp
RAIL=FreightCar America Inc
RAND=Rand Capital Corp
RANI=Rani Therapeutics Holdings, Inc.
RAPT=RAPT Therapeutics Inc
RARE=Ultragenyx Pharmaceutical Inc
RAVE=Rave Restaurant Group Inc
RAYA=Erayak Power Solution Group Inc.
RBB=RBB Bancorp
RBBN=Ribbon Communications Inc
RBCAA=Republic Bancorp Inc-KY
RBCN=Rubicon Technology Inc
RBKB=Rhinebeck Bancorp Inc
RCAT=Red Cat Holdings Inc.
RCEL=Avita Medical Ltd
RCKT=Rocket Pharmaceuticals Inc
RCKY=Rocky Brands Inc
RCLF=Rosecliff Acquisition Corp I
RCM=R1 RCM Inc
RCMT=RCM Technologies Inc
RCON=Recon Technology Ltd
RCRT=Recruiter.com Group, Inc.
RCRTW=Recruiter.com Group, Inc.
RDCM=RADCOM Ltd
RDFN=Redfin Corp
RDHL=Redhill Biopharma Ltd
RDI=Reading International Inc
RDIB=Reading International Inc
RDNT=RadNet Inc
RDUS=Radius Health Inc
RDVT=Red Violet Inc
RDWR=Radware Ltd
RDZN=Roadzen Inc
REAI=Intelligent Real Estate ETF
REAL=RealReal Inc-The
REAX=The Real Brokerage Inc.
REBN=Reborn Coffee, Inc.
REE=REE Automotive Ltd.
REED=Reed's Inc
REFI=Chicago Atlantic Real Estate Finance, Inc.
REFR=Research Frontiers Inc
REG=Regency Centers Corp
REGN=Regeneron Pharmaceuticals Inc
REKR=Rekor Systems Inc
RELI=Reliance Global Group Inc.
RELIW=Reliance Global Group, Inc.
RELL=Richardson Electronics Ltd-United States
RELY=Remitly Global, Inc.
RENB=Renovaro Biosciences Inc
RENE=Cartesian Growth Corporation II
RENEU=Cartesian Growth Corporation II
RENEW=Cartesian Growth Corporation II
RENT=Rent the Runway, Inc.
REPL=Replimune Group Inc
RETO=Reto Eco-solutions Inc
REVB=Revere Bank
REVBW=Revelation Biosciences, Inc.
REVHW=Revolution Healthcare Acquisiti
REYN=Reynolds Consumer Products Inc
RFAC=RF Acquisition Corp.
RFACR=RF Acquisition Corp.
RFACU=RF Acquisition Corp
RFACW=RF Acquisition Corp.
RFIL=RF Industries Ltd
RGC=Regencell Bioscience Holdings Limited
RGCO=RGC Resources Inc
RGEN=Repligen Corp
RGF=The Real Good Food Company, Inc.
RGLD=Royal Gold Inc
RGLS=Regulus Therapeutics Inc
RGNX=REGENXBIO Inc
RGP=Resources Connection Inc
RGS=Regis Corp
RGTI=Rigetti Computing, Inc.
RGTIW=Rigetti Computing, Inc.
RIBT=RiceBran Technologies
RICK=RCI Hospitality Holdings Inc
RIGL=Rigel Pharmaceuticals Inc
RILY=B. Riley Financial Inc
RILYG=B. Riley Financial Inc
RILYK=B. Riley Financial, Inc. 5.50% Senior Notes Due 2026
RILYL=B. Riley Financial Inc
RILYM=B. Riley Financial Inc
RILYN=B. Riley Financial Inc
RILYO=B. Riley Financial Inc
RILYP=B. Riley Financial Inc
RILYT=B. Riley Financial, Inc. 6.00% Senior Notes Due 2028
RILYZ=B. Riley Financial, Inc. 5.25% Senior Notes due 2028
RIOT=Riot Blockchain Inc
RIVN=Rivian Automotive, Inc. Class A Common Stock
RKDA=Arcadia Biosciences Inc
RKLB=Rocket Lab USA, Inc.
RLAY=Relay Therapeutics Inc
RLMD=Relmada Therapeutics Inc
RLYB=Rallybio Corporation
RMBI=Richmond Mutual Bancorporation Inc
RMBL=RumbleON Inc
RMBS=Rambus Inc
RMCF=Rocky Mountain Chocolate Factory Inc
RMCO=Royalty Management Holding Corporation
RMCOW=Royalty Management Holding Corporation
RMGC=RMG Acquisition Corp. III
RMGCU=RMG Acquisition Corp. III
RMGCW=RMG Acquisition Corp. III
RMNI=Rimini Street Inc
RMR=RMR GROUP INC-THE - A
RMTI=Rockwell Medical Inc
RNA=Avidity Biosciences Inc
RNAC=Cartesian Therapeutics, Inc.
RNAZ=TransCode Therapeutics, Inc.
RNLX=Renalytix AI plc
RNW=ReNew Energy Global plc
RNWWW=ReNew Energy Global plc
RNXT=RenovoRx, Inc.
ROAD=Construction Partners Inc
ROCK=Gibraltar Industries Inc
ROCL=Roth Ch Acquisition V Co.
ROCLU=Roth CH Acquisition V Co. Unit
ROCLW=Roth Ch Acquisition V Co.
ROI=RiskOn International, Inc.
ROIC=Retail Opportunity Investments Corp
ROII=Riskon International Inc
ROIV=Roivant Sciences Ltd.
ROIVW=Roivant Sciences Ltd.
ROKU=Roku Inc
ROLL=iShares Bloomberg Roll Select Commodity Swap UCITS ETF
ROLLP=RBC Bearings Incorporated
ROMA=Roma Green Finance Limited Ordinary Shares
ROOT=Root Inc-OH
ROP=Roper Technologies Inc
ROST=Ross Stores Inc
RPAY=Repay Holdings Corp
RPD=Rapid7 Inc
RPHM=Reneo Pharmaceuticals, Inc.
RPID=Rapid Micro Biosystems, Inc.
RPRX=Royalty Pharma PLC
RPTX=Repare Therapeutics Inc
RR=Richtech Robotics Inc.
RRBI=Red River Bancshares Inc
RRGB=Red Robin Gourmet Burgers Inc
RRR=Red Rock Resorts Inc
RSLS=ReShape Lifesciences Inc.
RSSS=Research Solutions, Inc.
RSVR=Reservoir Media, Inc.
RSVRW=Reservoir Media, Inc.
RTC=Baijiayun Group Ltd - Class
RUM=Rumble Inc.
RUMBW=Rumble Inc.
RUN=Sunrun Inc
RUSHA=Rush Enterprises Inc
RUSHB=Rush Enterprises Inc
RVMD=REVOLUTION Medicines Inc
RVMDW=Revolution Medicines, Inc.
RVNC=Revance Therapeutics Inc
RVPH=Reviva Pharmaceuticals Holdings, Inc.
RVPHW=Reviva Pharmaceuticals Holdings, Inc.
RVSB=Riverview Bancorp Inc
RVSN=Rail Vision Ltd.
RVSNW=Rail Vision Ltd.
RVYL=Ryvyl Inc.
RWAY=Runway Growth Finance Corp.
RWAYL=Runway Growth Finance Corp. - 7.50% Notes due 2027
RWAYZ=Runway Growth Finance Corp. - 8.00% Notes due 2027
RWOD=Redwoods Acquisition Corp.
RWODR=Redwoods Acquisition Corp.
RWODU=Redwoods Acquisition Corp
RWODW=Redwoods Acquisition Corp.
RXRX=Recursion Pharmaceuticals, Inc.
RXST=RxSight, Inc.
RXT=Rackspace Technology Inc
RYAAY=Ryanair Holdings PLC
RYTM=Rhythm Pharmaceuticals Inc
RZLT=Rezolute, Inc.
SABR=Sabre Corp
SABS=SAB Biotherapeutics, Inc.
SABSW=SAB Biotherapeutics, Inc.
SAFT=Safety Insurance Group Inc
SAGA=Sagaliam Acquisition Corp
SAGAR=Sagaliam Acquisition Corp.
SAGAU=Sagaliam Acquisition Corp
SAGE=Sage Therapeutics Inc
SAI=SAI.TECH Global Corporation
SAIA=Saia Inc
SAIC=Science Applications International Corp
SAITW=SAI.TECH Global Corporation
SALM=Salem Media Group Inc
SAMAW=Schultze Special Purpose Acquisition Corp. II
SAMG=Silvercrest Asset Management Group Inc
SANA=Sana Biotechnology, Inc.
SANG=Sangoma Technologies Corporation Common Shares
SANM=Sanmina Corp
SANW=S&W Seed Co
SASI=Sigma Labs, Inc.
SASR=Sandy Spring Bancorp Inc
SATL=Satellogic Inc.
SATLW=Satellogic Inc.
SATS=EchoStar Corp
SAVA=Cassava Sciences Inc
SAVAW=Cassava Sciences, Inc.
SBAC=SBA Communications Corp
SBCF=Seacoast Banking Corp of Florida
SBEAW=SilverBox Engaged Merger Corp I
SBET=SharpLink Gaming Ltd.
SBFG=SB Financial Group Inc
SBFM=Sunshine Biopharma Inc.
SBFMW=Sunshine Biopharma, Inc.
SBGI=Sinclair Broadcast Group Inc
SBLK=Star Bulk Carriers Corp
SBNY=Signature Bank-New York NY
SBOT=Serve Robotics Inc.
SBRA=Sabra Health Care REIT Inc
SBSI=Southside Bancshares Inc
SBT=Sterling Bancorp Inc-MI
SBTX=Silverback Therapeutics, Inc.
SBUX=Starbucks Corp
SCHL=Scholastic Corp
SCKT=Socket Mobile Inc
SCLX=Scilex Holding Company
SCLXW=Scilex Holding Company
SCNI=Scinai Immunotherapeutics Ltd.
SCOR=comScore Inc
SCPH=Scpharmaceuticals Inc
SCPS=Scopus BioPharma Inc.
SCRM=Screaming Eagle Acquisition Corp.
SCRMU=Screaming Eagle Acquisition Corp
SCRMW=Screaming Eagle Acquisition Corp.
SCSC=ScanSource Inc
SCTL=Societal CDMO Inc
SCVL=Shoe Carnival Inc
SCWO=374Water, Inc.
SCWX=SecureWorks Corp
SCYX=SCYNEXIS Inc
SDA=Suncar Technology Group Inc
SDC=SmileDirectClub, Inc.
SDGR=Schrodinger Inc-United States
SDIG=Stronghold Digital Mining, Inc.
SDOT=Sadot Group Inc
SEAT=Vivid Seats Inc.
SEATW=Vivid Seats Inc.
SECO=Secoo Holding Ltd
SEDG=SolarEdge Technologies Inc
SEED=Origin Agritech Ltd
SEEL=Seelos Therapeutics Inc
SEER=Seer, Inc.
SEIC=SEI Investments Co
SELF=Global Self Storage Inc
SELX=Semilux International Ltd. Ordinary Shares
SENEA=Seneca Foods Corp
SENEB=Seneca Foods Corp
SEPA=SEP Acquisition Corp
SEPAU=SEP Acquisition Corp.
SEPAW=SEP Acquisition Corp.
SERA=Sera Prognostics, Inc.
SERV=Serve Robotics Inc. Common Stock
SEVN=Seven Hills Realty Trust
SEZL=Sezzle Inc. - Common Stock
SFBC=Sound Financial Bancorp Inc
SFET=Safe-T Group Ltd
SFIX=Stitch Fix Inc
SFM=Sprouts Farmers Market Inc
SFNC=Simmons First National Corp
SFR=Appreciate Holdings, Inc.
SFRWW=Appreciate Holdings, Inc.
SFST=Southern First Bancshares Inc
SFT=Shift Technologies, Inc.
SFWL=Shengfeng Development Limited - Class A Ordinary Shares
SGA=Saga Communications Inc
SGBX=SG Blocks Inc
SGBXV=Safe & Green Holdings Corp.
SGC=Superior Group of Cos Inc
SGD=Safe and Green Development Corporation - Common Stock
SGDVV=Safe and Green Development Corporation
SGH=SMART Global Holdings Inc
SGHT=Sight Sciences, Inc.
SGII=Seaport Global Acquisition II Corp.
SGIIW=Seaport Global Acquisition II Corp.
SGLY=Singularity Future Technology Ltd.
SGMA=SigmaTron International Inc
SGML=Sigma Lithium Corporation
SGMO=Sangamo Therapeutics Inc
SGMS=Scientific Games Corp
SGMT=Sagimet Biosciences Inc. - Series A Common Stock
SGRP=SPAR Group Inc
SGRY=Surgery Partners Inc
SHBI=Shore Bancshares Inc
SHC=Sotera Health Co
SHCR=Sharecare, Inc.
SHCRW=Sharecare, Inc.
SHEN=Shenandoah Telecommunications Co
SHFS=SHF Holdings, Inc.
SHFSW=SHF Holdings, Inc.
SHIM=Shimmick Corporation
SHIP=Seanergy Maritime Holdings Corp
SHLS=Shoals Technologies Group, Inc.
SHOO=Steven Madden Ltd
SHOT=Safety Shot Inc
SHPH=Shuttle Pharmaceuticals Holdings Inc
SHPW=Shapeways Holdings, Inc.
SHQAW=Shelter Acquisition Corporation
SHYF=The Shyft Group, Inc.
SIBN=SI-BONE Inc
SIC=Select Interior Concepts Inc
SIDU=Sidus Space, Inc. Class A Common Stock
SIEB=Siebert Financial Corp
SIEN=Sientra Inc
SIERW=Sierra Lake Acquisition Corp.
SIFY=Sify Technologies Ltd
SIGA=SIGA Technologies Inc
SIGI=Selective Insurance Group Inc
SIGIP=Selective Insurance Group, Inc.
SILC=Silicom Ltd
SILK=Silk Road Medical Inc
SILO=Silo Pharma Inc.
SIMO=Silicon Motion Technology Corp
SINT=SiNtx Technologies Inc
SIRI=Sirius XM Holdings Inc
SISI=Shineco, Inc.
SITM=SiTime Corp
SJ=Scienjoy Holding Corporation
SKGR=SK Growth Opportunities Corp
SKGRU=SK Growth Opportunities Corp
SKGRW=SK Growth Opportunities Corporation
SKIN=The Beauty Health Company
SKWD=SKYWARD SPECIALTY INS GROUP INC
SKYE=Skye Bioscience, Inc.
SKYT=SkyWater Technology, Inc.
SKYW=SkyWest Inc
SKYX=SKYX Platforms Corp.
SLAB=Silicon Laboratories Inc
SLAC=Social Leverage Acquisition Corp I
SLACU=Social Leverage Acquisition Corp I
SLACW=Social Leverage Acquisition Corp I
SLAM=Slam Corp.
SLAMU=Slam Corp.
SLAMW=Slam Corp.
SLCR=Silver Crest Acquisition Corporation
SLDB=Solid Biosciences Inc
SLDP=Solid Power, Inc.
SLDPW=Solid Power, Inc.
SLE=Super League Gaming Inc
SLGCW=SomaLogic, Inc.
SLGG=Super League Gaming, Inc.
SLGL=Sol-Gel Technologies Ltd
SLM=SLM Corp
SLMBP=SLM Corp
SLN=Silence Therapeutics plc
SLNA=Selina Hospitality PLC
SLNAW=Selina Hospitality PLC
SLNDW=Southland Holdings, Inc.
SLNG=Stabilis Energy, Inc.
SLNH=Soluna Holdings, Inc.
SLNHP=Soluna Holdings, Inc. - 9.0% Se
SLNO=Soleno Therapeutics Inc
SLP=Simulations Plus Inc
SLRC=Solar Capital Ltd
SLRN=ACELYRIN, INC. - Common Stock
SLRX=Salarius Pharmaceuticals Inc
SLS=SELLAS Life Sciences Group Inc
SLVRW=SILVERspac Inc.
SMBC=Southern Missouri Bancorp Inc
SMCI=Super Micro Computer Inc
SMFL=Smart for Life, Inc.
SMFR=Sema4 Holdings Corp.
SMID=Smith-Midland Corp.
SMIT=Schmitt Industries Inc
SMLR=Semler Scientific, Inc.
SMMF=Summit Financial Group Inc
SMMT=Summit Therapeutics PLC
SMPL=Simply Good Foods Co-The
SMSI=Smith Micro Software Inc
SMTC=Lyxor Smart Cash
SMTI=Sanara MedTech Inc.
SMX=SMX (Security Matters) Public Limited Company - Class A Ordinary Shares
SMXT=Solarmax Technology Inc.
SNAL=Snail, Inc.
SNAX=Stryve Foods, Inc.
SNAXW=Stryve Foods, Inc.
SNBR=Sleep Number Corp
SNCR=Synchronoss Technologies Inc
SNCRL=Synchronoss Technologies, Inc. 8.375% Senior Notes due 2026
SNCY=Sun Country Airlines Holdings, Inc.
SND=Smart Sand Inc
SNDL=Sundial Growers Inc
SNDX=Syndax Pharmaceuticals Inc
SNES=Senestech Inc
SNEX=StoneX Group Inc.
SNFCA=Security National Financial Corp
SNGX=Soligenix Inc
SNOA=Sonoma Pharmaceuticals Inc
SNPO=Snap One Holdings Corp.
SNPS=Synopsys Inc
SNPX=Synaptogenix, Inc.
SNSE=Sensei Biotherapeutics, Inc.
SNT=Senstar Technologies Ltd.
SNTG=Sentage Holdings Inc.
SNTI=Senti Biosciences, Inc.
SNY=Sanofi
SOBR=SOBR Safe, Inc.
SOFI=SoFi Technologies, Inc.
SOFO=Sonic Foundry, Inc.
SOGP=LIZHI INC.
SOHO=Sotherly Hotels Inc
SOHOB=Sotherly Hotels Inc
SOHON=Sotherly Hotels Inc
SOHOO=Sotherly Hotels Inc
SOHU=Sohu.com Ltd
SOLO=ElectraMeccanica Vehicles Corp
SOND=Sonder Holdings Inc.
SONDW=Sonder Holdings Inc.
SONG=Akazoo SA
SONM=Sonim Technologies Inc
SONN=Sonnet BioTherapeutics Holdings Inc
SONO=Sonos Inc
SOPA=Society Pass Incorporated Common Stock
SOPH=SOPHiA GENETICS SA
SOTK=Sono-Tek Corp.
SOUN=SoundHound AI, Inc.
SOUNW=SoundHound AI, Inc.
SP=SP Plus Corp
SPCB=SuperCom Ltd
SPECW=Spectaire Holdings Inc.
SPFI=South Plains Financial Inc
SPGC=Sacks Parente Golf, Inc. - Common Stock
SPI=SPI Energy Co Ltd
SPKL=Spark I Acquisition Corp.
SPKLW=Spark I Acquisition Corporation
SPNS=Sapiens International Corp NV
SPOK=Spok Holdings Inc
SPPL=SIMPPLE LTD. - Ordinary Shares
SPRB=Spruce Biosciences Inc
SPRC=SciSparc Ltd.
SPRO=Spero Therapeutics Inc
SPRY=ARS Pharmaceuticals, Inc.
SPSC=SPS Commerce Inc
SPT=Sprout Social Inc
SPTN=SpartanNash Co
SPWH=Sportsman's Warehouse Holdings Inc
SPWR=SunPower Corp
SQFT=Presidio Property Trust Inc
SQFTP=Presidio Property Trust, Inc.
SQFTW=Presidio Property Trust, Inc.
SQLLW=SeqLL Inc.
SRAD=Sportradar Group AG
SRAX=Social Reality Inc
SRBK=SR Bancorp, Inc. - Common stock
SRCE=1st Source Corp
SRCL=Stericycle Inc
SRDX=Surmodics Inc
SRM=SRM Entertainment, Inc. - Common Stock
SRPT=Sarepta Therapeutics Inc
SRRK=Scholar Rock Holding Corp
SRTS=Sensus Healthcare Inc
SRZN=Surrozen, Inc.
SRZNW=Surrozen, Inc.
SSBI=Summit State Bank
SSBK=Southern States Bancshares, Inc.
SSIC=Silver Spike Investment Corp. Common Stock
SSKN=Strata Skin Sciences Inc
SSNC=SS&C Technologies Holdings Inc
SSNT=SilverSun Technologies Inc
SSP=EW Scripps Co-The
SSRM=SSR Mining Inc
SSSS=Sutter Rock Capital Corp
SSSSL=SuRo Capital Corp. 6.00% Notes due 2026
SSTI=ShotSpotter Inc
SSYS=Stratasys Ltd
STAA=STAAR Surgical Co
STAB=Statera Biopharma, Inc.
STAF=Staffing 360 Solutions Inc
STBA=S&T Bancorp Inc
STBX=Starbox Group Holdings Ltd
STCN=Steel Connect Inc
STEP=StepStone Group Inc.
STER=Sterling Check Corp.
STGW=Stagwell Inc.
STHO=Star Holdings - Shares of Beneficial Interest
STI=SunTrust Banks Inc
STIM=ETFS 1X Daily Short Tin
STIX=Semantix, Inc.
STIXW=Semantix, Inc.
STKH=Steakholder Foods Ltd.
STKL=SunOpta Inc
STKS=ONE Group Hospitality Inc-The
STLD=Steel Dynamics Inc
STNE=StoneCo Ltd
STOK=Stoke Therapeutics Inc
STRA=Strategic Education Inc
STRC=Sarcos Technology and Robotics Corporation
STRCW=Sarcos Technology and Robotics Corporation
STRDW=Sitio Royalties Corp.
STRL=Sterling Construction Co Inc
STRM=Streamline Health Solutions Inc
STRO=Sutro Biopharma Inc
STRR=Star Equity Holdings, Inc.
STRRP=Star Equity Holdings, Inc.
STRS=Stratus Properties Inc
STRT=Strattec Security Corp
STSS=Sharps Technology, Inc.
STSSW=Sharps Technology, Inc.
STTK=Shattuck Labs Inc
STX=Seagate Technology Holdings plc
SUGP=SU Group Holdings Limited Ordinary Shares
SUPN=Supernus Pharmaceuticals Inc
SURG=Surge Holdings, Inc.
SURGW=SurgePays, Inc.
SUUN=SolarBank Corporation Common Stock
SUUNF=SOLARBANK CORP
SVA=Sinovac Biotech Ltd
SVC=Service Properties Trust
SVFD=Save Foods, Inc.
SVII=Spring Valley Acquisition Corp. II
SVIIR=Spring Valley Acquisition Corp. II
SVIIU=Spring Valley Acquisition Corp. II
SVIIW=Spring Valley Acquisition Corp. II
SVMH=SRIVARU Holding Limited
SVMHW=SRIVARU Holding Limited
SVRA=Savara Inc
SVRE=Saverone 2014 Ltd
SVREW=SaverOne 2014 Ltd
SVVC=Firsthand Technology Value Fund Inc
SWAG=Software Acquisition Group Inc. III
SWAGW=Stran & Company, Inc.
SWAV=Shockwave Medical Inc
SWBI=Smith & Wesson Brands, Inc.
SWIM=Latham Group, Inc.
SWIN=Solowin Holdings - Ordinary Share
SWKH=SWK Holdings Corp
SWKS=Skyworks Solutions Inc
SWSS=Springwater Special Situations Corp.
SWSSU=Springwater Special Situations Corp.
SWSSW=Springwater Special Situations Corp.
SWTX=SpringWorks Therapeutics Inc
SWVL=Swvl Holdings Corp.
SWVLW=Swvl Holdings Corp.
SXTC=China SXT Pharmaceuticals Inc
SXTP=60 Degrees Pharmaceuticals, Inc. - Common Stock
SY=So-Young International Inc
SYBT=Stock Yards Bancorp Inc
SYBX=Synlogic Inc
SYM=Symbotic Inc.
SYNA=Synaptics Inc
SYPR=Sypris Solutions Inc
SYRA=Syra Health Corp. - Class A Common Stock
SYRE=Spyre Therapeutics, Inc.
SYRS=Syros Pharmaceuticals Inc
SYTA=Siyata Mobile Inc.
SYTAW=Siyata Mobile Inc.
SZZL=Sizzle Acquisition Corp.
SZZLU=Sizzle Acquisition Corp. Unit
SZZLW=Sizzle Acquisition Corp.
TACT=TransAct Technologies Inc
TAIT=Taitron Components Inc
TALK=Talkspace, Inc.
TALKW=Talkspace, Inc.
TALS=Talaris Therapeutics, Inc.
TANH=Tantech Holdings Ltd
TAOP=Taoping Inc
TARA=ArTara Therapeutics Inc
TARS=Tarsus Pharmaceuticals Inc
TASK=TaskUs, Inc.
TAST=Carrols Restaurant Group Inc
TATT=TAT Technologies Ltd
TAYD=Taylor Devices Inc
TBBK=Bancorp Inc-The
TBCPW=Thunder Bridge Capital Partners III Inc.
TBK=Triumph Bancorp Inc
TBLA=Taboola.com Ltd.
TBLAW=Taboola.com, Ltd.
TBLD=Thornburg Income Builder Opportunities Trust
TBLT=Toughbuilt Industries Inc
TBMC=Trailblazer Merger Corporation I - Class A Common Stock
TBNK=Territorial Bancorp Inc
TBPH=Theravance Biopharma Inc
TBRG=2
TBSAW=TB SA Acquisition Corp
TC=TuanChe Ltd
TCBC=TC Bancshares, Inc.
TCBI=Texas Capital Bancshares Inc
TCBIO=Texas Capital Bancshares, Inc.
TCBK=TriCo Bancshares
TCBP=TC Biopharm 
TCBPW=TC Biopharm 
TCBS=Texas Community Bancshares, Inc.
TCBX=Third Coast Bancshares, Inc.
TCJH=Top KingWin Ltd - Class A Ordinary Shares
TCMD=Tactile Systems Technology Inc
TCOM=Trip.com Group Ltd
TCON=Tracon Pharmaceuticals Inc
TCPC=BlackRock TCP Capital Corp
TCRT=Alaunos Therapeutics, Inc.
TCRX=TScan Therapeutics, Inc.
TCTM=Tarena International, Inc.
TCX=Tucows Inc
TDUP=ThredUp Inc.
TEAM=Atlassian Corp PLC
TECH=Bio-Techne Corp
TECTP=Tectonic Financial Inc
TELA=Tela Bio Inc
TELO=Telomir Pharmaceuticals, Inc. Common Stock
TENB=Tenable Holdings Inc
TENK=TenX Keane Acquisition
TENKR=TenX Keane Acquisition Corp.
TENKU=TenX Keane Acquisition
TENX=Tenax Therapeutics Inc
TER=Teradyne Inc
TERN=Terns Pharmaceuticals, Inc.
TETCW=Tech and Energy Transition Corp
TETE=Technology & Telecommunication Acquisition Corp
TETEU=Technology & Telecommunication Acquisition Corp
TETEW=Technology & Telecommunication Acquisition Corporation
TFFP=TFF Pharmaceuticals Inc
TFIN=Triumph Financial, Inc.
TFINP=Triumph Financial, Inc. - Depositary Shares, Each Representing a 1/40th Interest in a Share of Series C Fixed-Rate Non-Cumulative Perpetual Preferred Stock
TFSL=TFS Financial Corp
TGAA=Target Global Acquisition I Corp.
TGAAU=Target Global Acquisition I Corp.
TGAAW=Target Global Acquisition I Corp.
TGAN=Transphorm Inc
TGL=Treasure Global Inc.
TGTX=TG Therapeutics Inc
TGVC=TG Venture Acquisition Corp.
TGVCU=TG Venture Acquisition Corp.
TGVCW=TG Venture Acquisition Corp.
TH=Target Hospitality Corp
THAR=Tharimmune Inc
THCH=TH International Limited
THCP=Thunder Bridge Capital Partners IV Inc.
THCPU=Thunder Bridge Capital Partners IV Inc.
THFF=First Financial Corp-IN
THMO=ThermoGenesis Holdings Inc
THRD=Third Harmonic Bio Inc
THRM=Gentherm Inc
THRY=Thryv Holdings, Inc.
THTX=Theratechnologies Inc
THWWW=Target Hospitality Corp.
TIGO=Millicom International Cellular SA
TIGR=Up Fintech Holding Ltd
TIL=Instil Bio, Inc.
TILE=Interface Inc
TIO=Tingo Group, Inc.
TIPT=Tiptree Inc
TIRX=Tian Ruixiang Holdings Ltd
TITN=Titan Machinery Inc
TIVC=Tivic Health Systems, Inc.
TKLF=Yoshitsu Co., Ltd
TKNO=Alpha Teknova, Inc.
TLF=Tandy Leather Factory Inc
TLGY=TLGY Acquisition Corporation
TLGYU=TLGY Acquisition Corporation Unit
TLGYW=TLGY Acquisition Corporation
TLIS=Talis Biomedical Corporation
TLPH=AcelRx Pharmaceuticals, Inc.
TLRY=Tilray Inc
TLS=Telos Corp
TLSA=Tiziana Life Sciences PLC
TLSI=Trisalus Life Sciences Inc
TMC=TMC the metals company Inc.
TMCI=Treace Medical Concepts, Inc.
TMCWW=TMC the metals company Inc.
TMDX=TransMedics Group Inc
TMPOW=Tempo Automation Holdings, Inc.
TMTC=TMT Acquisition Corp - Ordinary Shares
TMUS=T-Mobile US Inc
TNDM=Tandem Diabetes Care Inc
TNGX=Tango Therapeutics, Inc.
TNON=Tenon Medical, Inc.
TNXP=Tonix Pharmaceuticals Holding Corp
TNYA=Tenaya Therapeutics, Inc.
TOI=The Oncology Institute, Inc.
TOIIW=The Oncology Institute, Inc.
TOMZ=TOMI Environmental Solutions, Inc.
TOP=TOP Financial Group Limited
TOPS=TOP Ships Inc
TORO=Toro Corp. - Common stock
TOUR=Tuniu Corp
TOWN=Towne Bank-Portsmouth VA
TPCS=Techprecision Corp.
TPG=TPG Inc.
TPGXL=TPG Inc. - 6.950% Fixed-Rate Junior Subordinated Notes due 2064
TPIC=TPI Composites Inc
TPST=Tempest Therapeutics Inc.
TRAW=Traws Pharma, Inc.
TRDA=Entrada Therapeutics, Inc.
TREE=LendingTree Inc
TRES=Defiance Treasury Alternative Yield ETF
TRIB=Trinity Biotech PLC
TRIN=Trinity Capital Inc.
TRINL=Trinity Capital Inc. - 7.00% Notes Due 2025
TRINZ=Trinity Capital Inc. 7.875% Notes due 2029
TRIP=TripAdvisor Inc
TRITW=Triterras, Inc.
TRKA=Troika Media Group, Inc.
TRKAW=Troika Media Group, Inc.
TRMB=Trimble Inc
TRMD=TORM PLC
TRMK=Trustmark Corp
TRML=Tourmaline Bio Inc
TRNR=Interactive Strength Inc. - Common Stock
TRNS=Transcat Inc
TRON=Toron, Inc.
TRONU=Corner Growth Acquisition Corp. 2
TRONW=Corner Growth Acquisition Corp. 2
TROO=TROOPS, Inc.
TROW=T Rowe Price Group Inc
TRS=Trimas Corp
TRSG=Tungray Technologies Inc Class A Ordinary Shares
TRST=TrustCo Bank Corp NY
TRUE=TrueCar Inc
TRUG=TruGolf, Inc.
TRUP=Trupanion Inc
TRVG=Trivago NV
TRVI=Trevi Therapeutics Inc
TRVN=Trevena Inc
TSAT=Telesat Corporation
TSBK=Timberland Bancorp Inc-WA
TSBX=Turnstone Biologics Corp. - Common Stock
TSCO=Tractor Supply Co
TSEM=Tower Semiconductor Ltd
TSHA=Taysha Gene Therapies Inc
TSIBU=Tishman Speyer Innovation Corp. II
TSLA=Tesla Inc
TSRI=TSR Inc
TSVT=2seventy bio, Inc.
TTD=Trade Desk Inc-The
TTEC=TTEC Holdings Inc
TTEK=Tetra Tech Inc
TTGT=TechTarget Inc
TTMI=TTM Technologies Inc
TTNP=Titan Pharmaceuticals Inc
TTOO=T2 Biosystems Inc
TTSH=Tile Shop Holdings, Inc.
TTWO=Take-Two Interactive Software Inc
TUGC=TradeUP Global Corporation
TUSK=Mammoth Energy Services Inc
TVGN=Semper Paratus Acquisition Corporation
TVGNW=Semper Paratus Acquisition Corporation
TVTX=Travere Therapeutics, Inc.
TW=Tradeweb Markets Inc
TWG=Top Wealth Group Holding Limited Ordinary Shares
TWIN=Twin Disc Inc
TWKS=Thoughtworks Holding, Inc.
TWLV=Twelve Seas Investment Company II
TWLVU=Twelve Seas Investment Company II
TWOU=2U Inc
TWST=Twist Bioscience Corp
TXG=10X Genomics Inc
TXMD=TherapeuticsMD Inc
TXN=Texas Instruments Inc
TXRH=Texas Roadhouse Inc
TYGO=Tigo Energy Inc
TYRA=Tyra Biosciences, Inc.
TZOO=Travelzoo
UAL=United Airlines Holdings Inc
UBCP=United Bancorp Inc-OH
UBFO=United Security Bancshares-Fresno CA
UBOH=United Bancshares Inc-OH
UBSI=United Bankshares Inc-WV
UBX=UNITY Biotechnology Inc
UBXG=U-BX Technology Ltd. Ordinary Shares
UCAR=U Power Limited - Ordinary Shares
UCBI=United Community Banks Inc-GA
UCBIO=United Community Banks, Inc.
UCL=Ucloudlink Group Inc
UCTT=Ultra Clean Holdings Inc
UDMY=Udemy, Inc.
UEIC=Universal Electronics Inc
UFCS=United Fire Group Inc
UFPI=Universal Forest Products Inc
UFPT=UFP Technologies Inc
UG=United-Guardian Inc
UGRO=URBAN-GRO INC.
UHG=United Homes Group Inc
UK=Ucommune International Ltd
UKOMW=Ucommune International Ltd
ULBI=Ultralife Corp
ULCC=Frontier Group Holdings, Inc.
ULH=Universal Logistics Holdings Inc
ULTA=Ulta Beauty Inc
ULY=Urgent.ly Inc. - Common Stock
UMBF=UMB Financial Corp
UNAM=Unico American Corp
UNB=Union Bankshares Inc-Morrisville VT
UNCY=Unicycive Therapeutics, Inc.
UNIT=Uniti Group Inc
UNTY=Unity Bancorp Inc
UONE=Urban One Inc
UONEK=Urban One Inc
UPBD=Upbound Group, Inc. - Common Stock
UPC=Universe Pharmaceuticals INC
UPLD=Upland Software Inc
UPST=Upstart Holdings, Inc.
UPTD=TradeUP Acquisition Corp.
UPWK=Upwork Inc
UPXI=Upexi Inc
URBN=Urban Outfitters Inc
URGN=UroGen Pharma Ltd
UROY=Uranium Royalty Corp.
USAP=Universal Stainless & Alloy Products Inc
USAU=Lyxor MSCI USA UCITS ETF
USCB=U.S. Century Bank
USCT=TKB Critical Technologies 1 Class A Ordinary Shares
USCTU=TKB Critical Technologies 1
USCTW=TKB Critical Technologies 1
USEA=United Maritime Corp
USEG=US Energy Corp Wyoming
USGO=U.S. GoldMining Inc. - Common stock
USGOW=U.S. GoldMining Inc. - Warrant
USIN=WISDOMTREE 7-10 YEAR LADDERED TREASURY FUND
USIO=Usio Inc
USLM=United States Lime & Minerals Inc
USOI=X-Links Crude Oil Shares Covered Call ETN
USSH=WisdomTree 1-3 Year Laddered Treasury Fund
UTHR=United Therapeutics Corp
UTMD=Utah Medical Products Inc
UTME=UTime Limited
UTRS=Minerva Surgical, Inc.
UTSI=UTStarcom Holdings Corp
UVSP=Univest Financial Corp
UXIN=Uxin Ltd
VABK=Virginia National Bankshares Corporation
VALN=Valneva SE
VALU=Value Line Inc
VANI=Vivani Medical Inc
VAQC=Vector Acquisition Corporation II
VAXX=Vaxxinity, Inc.
VBFC=Village Bank and Trust Financial Corp
VBIV=VBI Vaccines Inc
VBLT=Vascular Biogenics Ltd.
VBNK=VersaBank
VBTX=Veritex Holdings Inc
VC=Visteon Corp
VCEL=Vericel Corp
VCIG=VCI Global Limited - Ordinary Share
VCKA=Vickers Vantage Corp. I
VCNX=Vaccinex Inc
VCSA=Vacasa, Inc.
VCTR=Victory Capital Holdings Inc
VCYT=Veracyte Inc
VECO=Veeco Instruments Inc
VEEE=Twin Vee Powercats Co.
VENA=Venus Acquisition Corporation
VEON=VEON Ltd
VERA=Vera Therapeutics, Inc.
VERB=Verb Technology Co Inc
VERBW=Verb Technology Company, Inc.
VERI=Veritone Inc
VERO=Venus Concept Inc
VERU=Veru Inc
VERV=Verve Therapeutics, Inc.
VERX=Vertex Inc
VERY=Vericity Inc
VEV=Vicinity Motor Corp.
VFF=Village Farms International Inc
VFS=Vinfast Auto Ltd.
VGAS=Verde Clean Fuels, Inc. - Class A Common Stock
VHNA=Vahanna Tech Edge Acquisition I Corp.
VIA=Viacom Inc
VIASP=Via Renewables, Inc.
VIAV=Viavi Solutions Inc
VICR=Vicor Corp
VIEW=View, Inc.
VIEWW=View, Inc.
VIGL=Vigil Neuroscience, Inc.
VINC=Vincerx, Inc.
VINO=Gaucho Group Holdings Inc. 
VINP=Vinci Partners Investments Ltd.
VIOT=Viomi Technology Co Ltd
VIR=Vir Biotechnology Inc
VIRC=Virco Manufacturing Corp
VIRI=Virios Therapeutics, LLC
VIRT=Virtu Financial Inc
VIRX=Viracta Therapeutics, Inc.
VISL=Vislink Technologies Inc
VITL=Vital Farms Inc
VIVE=Viveve Medical Inc
VIVK=Vivakor Inc.
VJET=voxeljet AG
VJTTY=Voxeljet Ag
VKTX=Viking Therapeutics Inc
VLCN=Volcon, Inc.
VLGEA=Village Super Market Inc
VLON=Vallon Pharmaceuticals, Inc.
VLY=Valley National Bancorp
VLYPO=Valley National Bancorp
VLYPP=Valley National Bancorp
VMAR=Vision Marine Technologies Inc.
VMCA=Valuence Merger Corp. I
VMCAU=Valuence Merger Corp I
VMCAW=Valuence Merger Corp. I
VMD=Viemed Healthcare Inc
VMEO=Vimeo, Inc.
VNDA=Vanda Pharmaceuticals Inc
VNET=21Vianet Group Inc
VNOM=Viper Energy Partners LP
VOD=Vodafone Group PLC
VOR=Vor Biopharma Inc.
VOXR=Vox Royalty Corp.
VOXX=VOXX International Corp
VPCBW=VPC Impact Acquisition Holdings
VRA=Vera Bradley Inc
VRAR=The Glimpse Group, Inc.
VRAX=Virax Biolabs Group Limited
VRCA=Verrica Pharmaceuticals Inc
VRDN=Viridian Therapeutics, Inc.
VREX=Varex Imaging Corp
VRM=Vroom Inc
VRME=VerifyMe, Inc.
VRMEW=VerifyMe, Inc.
VRNA=Verona Pharma PLC
VRNS=Varonis Systems Inc
VRNT=Verint Systems Inc
VRPX=Virpax Pharmaceuticals, Inc.
VRRM=Verra Mobility Corp
VRSK=Verisk Analytics Inc
VRSN=VeriSign Inc
VRSSF=Versus Systems Inc.
VRTX=Vertex Pharmaceuticals Inc
VS=Versus Systems Inc.
VSAC=Vision Sensing Acquisition Corp.
VSACU=Vision Sensing Acquisition Corp. Unit
VSACW=Vision Sensing Acquisition Corp.
VSAT=ViaSat Inc
VSEC=VSE Corp
VSME=VS Media Holdings Limited - Class A Ordinary Shares
VSSYW=Versus Systems Inc.
VSTA=Vasta Platform Ltd
VSTE=Vast Renewables Limited
VSTEW=Vast Renewables Limited
VSTM=Verastem Inc
VTGN=VistaGen Therapeutics Inc
VTNR=Vertex Energy Inc
VTRS=Viatris Inc
VTRU=Vitru Limited
VTSI=VirTra Inc
VTVT=vTv Therapeutics Inc
VTYX=Ventyx Biosciences, Inc.
VUZI=Vuzix Corp
VVOS=Vivos Therapeutics, Inc.
VVPR=VivoPower International PLC
VWE=Vintage Wine Estates, Inc.
VWEWW=Vintage Wine Estates, Inc.
VXRT=Vaxart Inc
VYGR=Voyager Therapeutics Inc
VYNE=VYNE Therapeutics Inc.
WABC=Westamerica Bancorporation
WAFD=Washington Federal Inc
WAFDP=Washington Federal, Inc.
WAFU=Wah Fu Education Group Ltd
WALD=Waldencast Acquisition Corp.
WALDW=Waldencast plc
WASH=Washington Trust Bancorp Inc
WATT=Energous Corp
WAVD=
WAVE=Eco Wave Power Global AB (publ)
WAVS=Western Acquisition Ventures Corp.
WAVSU=Western Acquisition Ventures Corp
WAVSW=Western Acquisition Ventures Corp.
WB=Weibo Corp
WBA=Walgreens Boots Alliance Inc
WBD=Warner Bros. Discovery, Inc.
WBUY=WEBUY GLOBAL LTD. - Ordinary Shares
WDAY=Workday Inc
WDC=Western Digital Corp
WDFC=WD-40 Co
WEJOW=Wejo Group Limited
WEN=Wendy's Co-The
WERN=Werner Enterprises Inc
WEST=Westrock Coffee Holdings LLC
WESTW=Westrock Coffee Company, LLC
WETF=WisdomTree Investments Inc
WETG=WeTrade Group Inc.
WETH=Wetouch Technology Inc.
WEYS=Weyco Group Inc
WFCF=Where Food Comes From, Inc.
WFRD=Weatherford International plc
WGS=Sema4 Holdings Corp.
WGSWW=GeneDx Holdings Corp.
WHF=WhiteHorse Finance Inc
WHLM=Wilhelmina International Inc
WHLR=Wheeler Real Estate Investment Trust Inc
WHLRD=Wheeler Real Estate Investment Trust Inc
WHLRL=Wheeler Real Estate Investment Trust, Inc.
WHLRP=Wheeler Real Estate Investment Trust Inc
WILC=G Willi-Food International Ltd
WIMI=WiMi Hologram Cloud Inc
WINA=Winmark Corp
WING=iShares Fallen Angels High Yield Corp Bond UCITS ETF
WINT=Windtree Therapeutics, Inc.
WINV=WinVest Acquisition Corp. Common Stock
WINVR=WinVest Acquisition Corp.
WINVW=WinVest Acquisition Corp.
WIRE=Encore Wire Corp
WISA=Summit Wireless Technologies Inc
WISH=ContextLogic Inc.
WIX=Wix.com Ltd
WKEY=WISeKey International Holding Ltd
WKEYV=WISeKey International Holding L
WKHS=Workhorse Group Inc
WKME=WalkMe Ltd.
WKSP=Worksport Ltd.
WKSPW=Worksport Ltd.
WLDN=Willdan Group Inc
WLDS=Wearable Devices Ltd
WLDSW=Wearable Devices Ltd.
WLFC=Willis Lease Finance Corp
WLGS=Wang & Lee Group, Inc. - Ordinary Shares
WLTW=Willis Towers Watson PLC
WMG=Warner Music Group Corp
WMPN=William Penn Bancorp, Inc.
WNEB=Western New England Bancorp Inc
WNW=Wunong Net Technology Company Limited
WOOF=Petco Health and Wellness Company, Inc.
WORX=SCWorx Corp
WPRT=Westport Fuel Systems Inc
WRAP=Wrap Technologies, Inc.
WRLD=World Acceptance Corp
WSBC=WesBanco Inc
WSBCP=WesBanco, Inc.
WSBF=Waterstone Financial Inc
WSC=Willscot Corp
WSFS=WSFS Financial Corp
WSTG=Wayside Technology Group Inc
WTBA=West Bancorporation Inc
WTFC=Wintrust Financial Corp
WTFCM=Wintrust Financial Corp
WTFCP=Wintrust Financial Corporation
WTMA=Welsbach Technology Metals Acquisition Corp.
WTMAR=Welsbach Technology Metals Acquisition Corp.
WTMAU=Welsbach Technology Metals Acquisition Corp
WTO=Utime Ltd.
WTW=Willis Towers Watson Public Lim
WULF=TeraWulf Inc.
WVE=WaVe Life Sciences Ltd
WVFC=WVS Financial Corp
WVVI=Willamette Valley Vineyards Inc
WVVIP=Willamette Valley Vineyards Inc
WW=Weight Watchers International Inc
WWAC=Worldwide Webb Acquisition Corp. Class A Ordinary Share
WWACU=Worldwide Webb Acquisition Corp.
WWD=Woodward Inc
WYNN=Wynn Resorts Ltd
XAIR=Beyond Air Inc
XBIO=Xenetic Biosciences Inc
XBIOW=Xenetic Biosciences, Inc.
XBIT=XBiotech Inc
XBP=XBP Europe Holdings, Inc.
XBPEW=XBP Europe Holdings, Inc.
XCUR=Exicure Inc
XEL=Xcel Energy Inc
XELA=Exela Technologies Inc
XELAP=Exela Technologies, Inc. - 6.00% Series B Cumulative Convertible Perpetual Preferred Stock
XELB=Xcel Brands Inc
XENE=Xenon Pharmaceuticals Inc
XERS=Xeris Pharmaceuticals Inc
XFIN=ExcelFin Acquisition Corp Class A Common Stock
XFINU=ExcelFin Acquisition Corp.
XFINW=ExcelFin Acquisition Corp.
XFOR=X4 Pharmaceuticals Inc
XGN=Exagen Inc
XLO=Xilio Therapeutics, Inc.
XLYO=Xylo Technologies Ltd.
XMTR=Xometry, Inc.
XNCR=Xencor Inc
XNET=Xunlei Ltd
XOMA=XOMA Corp
XOMAO=XOMA Corporation
XOMAP=XOMA Corporation
XOS=Xos, Inc.
XOSWW=Xos, Inc.
XP=XP Inc
XPDB=Power & Digital Infrastructure Acquisition II Corp.
XPDBU=Power & Digital Infrastructure Acquisition II Corp. Unit
XPDBW=Power & Digital Infrastructure Acquisition II Corp.
XPEL=XPEL Inc
XPON=Expion360 Inc.
XRAY=DENTSPLY SIRONA Inc
XRTX=XORTX Therapeutics Inc.
XRX=Xerox Corp
XSPA=XpresSpa Group Inc
XTIA=XTI Aerospace, Inc.
XTKG=Powerbridge Technologies Co., Ltd.
XTLB=XTL Biopharmaceuticals Ltd
XWEL=XWELL, Inc.
XXII=22nd Century Group Inc
XYLO=Xylo Technologies Ltd.
YGF=YanGuFang International Group Co., Ltd. - Ordinary Shares
YGMZ=MingZhu Logistics Holdings Ltd
YHGJ=Yunhong Green Cti Ltd.
YI=111 Inc
YIBO=Planet Image International Limited Class A Ordinary Shares
YJ=Yunji Inc
YMAB=Y-mAbs Therapeutics Inc
YNDX=Yandex NV
YORW=York Water Co-The
YOSH=Yoshiharu Global Co
YOTA=Yotta Acquisition Corporation
YOTAR=Yotta Acquisition Corporation
YOTAU=Yotta Acquisition Corporation
YOTAW=Yotta Acquisition Corporation
YQ=17 Education & Technology Group Inc.
YRIV=Yangtze River Port & Logistics Ltd
YS=Ys Biopharma Co Ltd.
YTEN=Yield10 Bioscience Inc
YTRA=Yatra Online Inc
YY=YY Inc
YYAI=Connexa Sports Technologies Inc.
YYGH=YY Group Holding Limited Class A Ordinary Shares
Z=Zillow Group Inc
ZAPP=Zapp Electric Vehicles Group Ltd.
ZBAO=Zhibao Technology Inc.
ZBRA=Zebra Technologies Corp
ZCAR=Zoomcar Holdings, Inc.
ZCARW=Zoomcar Holdings, Inc.
ZCMD=Zhongchao Inc
ZD=Ziff Davis, Inc.
ZENV=Zenvia Inc.
ZEO=ESGEN Acquisition Corporation
ZEOWW=ESGEN Acquisition Corporation
ZEUS=Olympic Steel Inc
ZFOX=ZeroFox Holdings, Inc.
ZFOXW=ZeroFox Holdings, Inc.
ZG=Zillow Group Inc
ZI=ZoomInfo Technologies Inc
ZIMV=ZimVie Inc.
ZION=Zions Bancorp NA
ZIONL=Zions Bancorp NA
ZIONO=Zions Bancorp NA
ZIONP=Zions Bancorp NA
ZIVO=Zivo Bioscience, Inc.
ZIVOW=ZIVO Bioscience, Inc.
ZJYL=JIN MEDICAL INTERNATIONAL LTD. - Ordinary Shares
ZKIN=ZK International Group Co Ltd
ZLAB=Zai Lab Ltd
ZLS=Zalatoris II Acquisition Corp - Class A Ordinary Shares
ZM=Zoom Video Communications Inc
ZNTL=Zentalis Pharmaceuticals Inc
ZOOZ=ZOOZ Power Ltd. Ordinary Shares
ZOOZW=ZOOZ Power Ltd. Warrant
ZPTA=Zapata Computing Holdings Inc. Common Stock
ZPTAW=Zapata Computing Holdings Inc. Warrant
ZS=Zscaler Inc
ZTEK=Zentek Ltd.
ZUMZ=Zumiez Inc
ZURA=Zura Bio Ltd.
ZVRA=KemPharm Inc
ZVSA=ZyVersa Therapeutics, Inc.
ZVZZT=
ZWRKU=Z-Work Acquisition Corp.
ZYME=Zymeworks Inc
ZYXI=Zynex Inc
